Id	Print_Name	Inverted_Name
aaa	Ghotuo	Ghotuo
aab	Alumu-Tesu	Alumu-Tesu
aac	Ari	Ari
aad	Amal	Amal
aae	Arbresh Albanian	Albanian, Arbresh
aaf	Aranadan	Aranadan
aag	Ambrak	Ambrak
aah	Abu' Arapesh	Arapesh, Abu'
aai	Arifama-Miniafia	Arifama-Miniafia
aak	Ankave	Ankave
aal	Afade	Afade
aan	Anamb	Anamb
aao	Algerian Saharan Arabic	Arabic, Algerian Saharan
aap	Par Arra	Arra, Par
aaq	Eastern Abnaki	Abnaki, Eastern
aar	Afar	Afar
aas	Aasx	Aasx
aat	Arvanitika Albanian	Albanian, Arvanitika
aau	Abau	Abau
aaw	Solong	Solong
aax	Mandobo Atas	Mandobo Atas
aaz	Amarasi	Amarasi
aba	Ab	Ab
abb	Bankon	Bankon
abc	Ambala Ayta	Ayta, Ambala
abd	Manide	Manide
abe	Western Abnaki	Abnaki, Western
abf	Abai Sungai	Abai Sungai
abg	Abaga	Abaga
abh	Tajiki Arabic	Arabic, Tajiki
abi	Abidji	Abidji
abj	Aka-Bea	Aka-Bea
abk	Abkhazian	Abkhazian
abl	Lampung Nyo	Lampung Nyo
abm	Abanyom	Abanyom
abn	Abua	Abua
abo	Abon	Abon
abp	Abellen Ayta	Ayta, Abellen
abq	Abaza	Abaza
abr	Abron	Abron
abs	Ambonese Malay	Malay, Ambonese
abt	Ambulas	Ambulas
abu	Abure	Abure
abv	Baharna Arabic	Arabic, Baharna
abw	Pal	Pal
abx	Inabaknon	Inabaknon
aby	Aneme Wake	Aneme Wake
abz	Abui	Abui
aca	Achagua	Achagua
acb	nc	nc
acd	Gikyode	Gikyode
ace	Achinese	Achinese
acf	Saint Lucian Creole French	Creole French, Saint Lucian
ach	Acoli	Acoli
aci	Aka-Cari	Aka-Cari
ack	Aka-Kora	Aka-Kora
acl	Akar-Bale	Akar-Bale
acm	Mesopotamian Arabic	Arabic, Mesopotamian
acn	Achang	Achang
acp	Eastern Acipa	Acipa, Eastern
acq	Ta'izzi-Adeni Arabic	Arabic, Ta'izzi-Adeni
acr	Achi	Achi
acs	Acro	Acro
act	Achterhoeks	Achterhoeks
acu	Achuar-Shiwiar	Achuar-Shiwiar
acv	Achumawi	Achumawi
acw	Hijazi Arabic	Arabic, Hijazi
acx	Omani Arabic	Arabic, Omani
acy	Cypriot Arabic	Arabic, Cypriot
acz	Acheron	Acheron
ada	Adangme	Adangme
adb	Adabe	Adabe
add	Dzodinka	Dzodinka
ade	Adele	Adele
adf	Dhofari Arabic	Arabic, Dhofari
adg	Andegerebinha	Andegerebinha
adh	Adhola	Adhola
adi	Adi	Adi
adj	Adioukrou	Adioukrou
adl	Galo	Galo
adn	Adang	Adang
ado	Abu	Abu
adq	Adangbe	Adangbe
adr	Adonara	Adonara
ads	Adamorobe Sign Language	Adamorobe Sign Language
adt	Adnyamathanha	Adnyamathanha
adu	Aduge	Aduge
adw	Amundava	Amundava
adx	Amdo Tibetan	Tibetan, Amdo
ady	Adygei	Adygei
ady	Adyghe	Adyghe
adz	Adzera	Adzera
aea	Areba	Areba
aeb	Tunisian Arabic	Arabic, Tunisian
aec	Saidi Arabic	Arabic, Saidi
aed	Argentine Sign Language	Argentine Sign Language
aee	Northeast Pashai	Pashai, Northeast
aee	Northeast Pashayi	Pashayi, Northeast
aek	Haeke	Haeke
ael	Ambele	Ambele
aem	Arem	Arem
aen	Armenian Sign Language	Armenian Sign Language
aeq	Aer	Aer
aer	Eastern Arrernte	Arrernte, Eastern
aes	Alsea	Alsea
aeu	Akeu	Akeu
aew	Ambakich	Ambakich
aey	Amele	Amele
aez	Aeka	Aeka
afb	Gulf Arabic	Arabic, Gulf
afd	Andai	Andai
afe	Putukwam	Putukwam
afg	Afghan Sign Language	Afghan Sign Language
afh	Afrihili	Afrihili
afi	Akrukay	Akrukay
afi	Chini	Chini
afk	Nanubae	Nanubae
afn	Defaka	Defaka
afo	Eloyi	Eloyi
afp	Tapei	Tapei
afr	Afrikaans	Afrikaans
afs	Afro-Seminole Creole	Creole, Afro-Seminole
aft	Afitti	Afitti
afu	Awutu	Awutu
afz	Obokuitai	Obokuitai
aga	Aguano	Aguano
agb	Legbo	Legbo
agc	Agatu	Agatu
agd	Agarabi	Agarabi
age	Angal	Angal
agf	Arguni	Arguni
agg	Angor	Angor
agh	Ngelima	Ngelima
agi	Agariya	Agariya
agj	Argobba	Argobba
agk	Isarog Agta	Agta, Isarog
agl	Fembe	Fembe
agm	Angaataha	Angaataha
agn	Agutaynen	Agutaynen
ago	Tainae	Tainae
agq	Aghem	Aghem
agr	Aguaruna	Aguaruna
ags	Esimbi	Esimbi
agt	Central Cagayan Agta	Agta, Central Cagayan
agu	Aguacateco	Aguacateco
agv	Remontado Dumagat	Dumagat, Remontado
agw	Kahua	Kahua
agx	Aghul	Aghul
agy	Southern Alta	Alta, Southern
agz	Mt. Iriga Agta	Agta, Mt. Iriga
aha	Ahanta	Ahanta
ahb	Axamb	Axamb
ahg	Qimant	Qimant
ahh	Aghu	Aghu
ahi	Tiagbamrin Aizi	Aizi, Tiagbamrin
ahk	Akha	Akha
ahl	Igo	Igo
ahm	Mobumrin Aizi	Aizi, Mobumrin
ahn	hn	hn
aho	Ahom	Ahom
ahp	Aproumu Aizi	Aizi, Aproumu
ahr	Ahirani	Ahirani
ahs	Ashe	Ashe
aht	Ahtena	Ahtena
aia	Arosi	Arosi
aib	Ainu (China)	Ainu (China)
aic	Ainbai	Ainbai
aid	Alngith	Alngith
aie	Amara	Amara
aif	Agi	Agi
aig	Antigua and Barbuda Creole English	Creole English, Antigua and Barbuda
aih	Ai-Cham	Ai-Cham
aii	Assyrian Neo-Aramaic	Neo-Aramaic, Assyrian
aij	Lishanid Noshan	Lishanid Noshan
aik	Ake	Ake
ail	Aimele	Aimele
aim	Aimol	Aimol
ain	Ainu (Japan)	Ainu (Japan)
aio	Aiton	Aiton
aip	Burumakok	Burumakok
aiq	Aimaq	Aimaq
air	Airoran	Airoran
ais	Nataoran Amis	Amis, Nataoran
ait	Arikem	Arikem
aiw	Aari	Aari
aix	Aighon	Aighon
aiy	Ali	Ali
aja	Aja (Sudan)	Aja (Sudan)
ajg	Aja (Benin)	Aja (Benin)
aji	Aji	Aji
ajn	Andajin	Andajin
ajp	South Levantine Arabic	Arabic, South Levantine
ajt	Judeo-Tunisian Arabic	Arabic, Judeo-Tunisian
aju	Judeo-Moroccan Arabic	Arabic, Judeo-Moroccan
ajw	Ajawa	Ajawa
ajz	Amri Karbi	Karbi, Amri
aka	Akan	Akan
akb	Batak Angkola	Batak Angkola
akc	Mpur	Mpur
akd	Ukpet-Ehom	Ukpet-Ehom
ake	Akawaio	Akawaio
akf	Akpa	Akpa
akg	Anakalangu	Anakalangu
akh	Angal Heneng	Angal Heneng
aki	Aiome	Aiome
akj	Aka-Jeru	Aka-Jeru
akk	Akkadian	Akkadian
akl	Aklanon	Aklanon
akm	Aka-Bo	Aka-Bo
ako	Akurio	Akurio
akp	Siwu	Siwu
akq	Ak	Ak
akr	Araki	Araki
aks	Akaselem	Akaselem
akt	Akolet	Akolet
aku	Akum	Akum
akv	Akhvakh	Akhvakh
akw	Akwa	Akwa
akx	Aka-Kede	Aka-Kede
aky	Aka-Kol	Aka-Kol
akz	Alabama	Alabama
ala	Alago	Alago
alc	Qawasqar	Qawasqar
ald	Alladian	Alladian
ale	Aleut	Aleut
alf	Alege	Alege
alh	Alawa	Alawa
ali	Amaimon	Amaimon
alj	Alangan	Alangan
alk	Alak	Alak
all	Allar	Allar
alm	Amblong	Amblong
aln	Gheg Albanian	Albanian, Gheg
alo	Larike-Wakasihu	Larike-Wakasihu
alp	Alune	Alune
alq	Algonquin	Algonquin
alr	Alutor	Alutor
als	Tosk Albanian	Albanian, Tosk
alt	Southern Altai	Altai, Southern
alu	'Are'are	'Are'are
alw	Alaba-Kabeena	Alaba-Kabeena
alw	Wanbasana	Wanbasana
alx	Amol	Amol
aly	Alyawarr	Alyawarr
alz	Alur	Alur
ama	Amanay	Amanay
amb	Ambo	Ambo
amc	Amahuaca	Amahuaca
ame	Yanesha'	Yanesha'
amf	Hamer-Banna	Hamer-Banna
amg	Amurdak	Amurdak
amh	Amharic	Amharic
ami	Amis	Amis
amj	Amdang	Amdang
amk	Ambai	Ambai
aml	War-Jaintia	War-Jaintia
amm	Ama (Papua New Guinea)	Ama (Papua New Guinea)
amn	Amanab	Amanab
amo	Amo	Amo
amp	Alamblak	Alamblak
amq	Amahai	Amahai
amr	Amarakaeri	Amarakaeri
ams	Southern Amami-Oshima	Amami-Oshima, Southern
amt	Amto	Amto
amu	Guerrero Amuzgo	Amuzgo, Guerrero
amv	Ambelau	Ambelau
amw	Western Neo-Aramaic	Neo-Aramaic, Western
amx	Anmatyerre	Anmatyerre
amy	Ami	Ami
amz	Atampaya	Atampaya
ana	Andaqui	Andaqui
anb	Andoa	Andoa
anc	Ngas	Ngas
and	Ansus	Ansus
ane	Xrc	Xrc
anf	Animere	Animere
ang	Old English (ca. 450-1100)	English, Old (ca. 450-1100)
anh	Nend	Nend
ani	Andi	Andi
anj	Anor	Anor
ank	Goemai	Goemai
anl	Anu-Hkongso Chin	Chin, Anu-Hkongso
anm	Anal	Anal
ann	Obolo	Obolo
ano	Andoque	Andoque
anp	Angika	Angika
anq	Jarawa (India)	Jarawa (India)
anr	Andh	Andh
ans	Anserma	Anserma
ant	Antakarinya	Antakarinya
anu	Anuak	Anuak
anv	Denya	Denya
anw	Anaang	Anaang
anx	Andra-Hus	Andra-Hus
any	Anyin	Anyin
anz	Anem	Anem
aoa	Angolar	Angolar
aob	Abom	Abom
aoc	Pemon	Pemon
aod	Andarum	Andarum
aoe	Angal Enen	Angal Enen
aof	Bragat	Bragat
aog	Angoram	Angoram
aoh	Arma	Arma
aoi	Anindilyakwa	Anindilyakwa
aoj	Mufian	Mufian
aok	Arh	Arh
aol	Alor	Alor
aom	mie	mie
aon	Bumbita Arapesh	Arapesh, Bumbita
aor	Aore	Aore
aos	Taikat	Taikat
aot	A'tong	A'tong
aot	Atong (India)	Atong (India)
aou	A'ou	A'ou
aox	Atorada	Atorada
aoz	Uab Meto	Uab Meto
apb	Sa'a	Sa'a
apc	North Levantine Arabic	Arabic, North Levantine
apd	Sudanese Arabic	Arabic, Sudanese
ape	Bukiyip	Bukiyip
apf	Pahanan Agta	Agta, Pahanan
apg	Ampanang	Ampanang
aph	Athpariya	Athpariya
api	Apiak	Apiak
apj	Jicarilla Apache	Apache, Jicarilla
apk	Kiowa Apache	Apache, Kiowa
apl	Lipan Apache	Apache, Lipan
apm	Mescalero-Chiricahua Apache	Apache, Mescalero-Chiricahua
apn	Apinay	Apinay
apo	Ambul	Ambul
app	Apma	Apma
apq	A-Pucikwar	A-Pucikwar
apr	Arop-Lokep	Arop-Lokep
aps	Arop-Sissano	Arop-Sissano
apt	Apatani	Apatani
apu	Apurin	Apurin
apv	Alapmunte	Alapmunte
apw	Western Apache	Apache, Western
apx	Aputai	Aputai
apy	Apala	Apala
apz	Safeyoka	Safeyoka
aqc	Archi	Archi
aqd	Ampari Dogon	Dogon, Ampari
aqg	Arigidi	Arigidi
aqm	Atohwaim	Atohwaim
aqn	Northern Alta	Alta, Northern
aqp	Atakapa	Atakapa
aqr	Arh	Arh
aqt	Angait	Angait
aqz	Akuntsu	Akuntsu
ara	Arabic	Arabic
arb	Standard Arabic	Arabic, Standard
arc	Imperial Aramaic (700-300 BCE)	Aramaic, Imperial (700-300 BCE)
arc	Official Aramaic (700-300 BCE)	Aramaic, Official (700-300 BCE)
ard	Arabana	Arabana
are	Western Arrarnta	Arrarnta, Western
arg	Aragonese	Aragonese
arh	Arhuaco	Arhuaco
ari	Arikara	Arikara
arj	Arapaso	Arapaso
ark	Arikap	Arikap
arl	Arabela	Arabela
arn	Mapuche	Mapuche
arn	Mapudungun	Mapudungun
aro	Araona	Araona
arp	Arapaho	Arapaho
arq	Algerian Arabic	Arabic, Algerian
arr	Karo (Brazil)	Karo (Brazil)
ars	Najdi Arabic	Arabic, Najdi
aru	Araw	Araw
aru	Aru (Amazonas State)	Aru (Amazonas State)
arv	Arbore	Arbore
arw	Arawak	Arawak
arx	Aru (Rodonia State)	Aru (Rodonia State)
ary	Moroccan Arabic	Arabic, Moroccan
arz	Egyptian Arabic	Arabic, Egyptian
asa	Asu (Tanzania)	Asu (Tanzania)
asb	Assiniboine	Assiniboine
asc	Casuarina Coast Asmat	Asmat, Casuarina Coast
asd	Asas	Asas
ase	American Sign Language	American Sign Language
asf	Australian Sign Language	Australian Sign Language
asg	Cishingini	Cishingini
ash	Abishira	Abishira
asi	Buruwai	Buruwai
asj	Sari	Sari
ask	Ashkun	Ashkun
asl	Asilulu	Asilulu
asm	Assamese	Assamese
asn	Xing Asurin	Asurin, Xing
aso	Dano	Dano
asp	Algerian Sign Language	Algerian Sign Language
asq	Austrian Sign Language	Austrian Sign Language
asr	Asuri	Asuri
ass	Ipulo	Ipulo
ast	Asturian	Asturian
ast	Asturleonese	Asturleonese
ast	Bable	Bable
ast	Leonese	Leonese
asu	Tocantins Asurini	Asurini, Tocantins
asv	Asoa	Asoa
asw	Australian Aborigines Sign Language	Australian Aborigines Sign Language
asx	Muratayak	Muratayak
asy	Yaosakor Asmat	Asmat, Yaosakor
asz	As	As
ata	Pele-Ata	Pele-Ata
atb	Zaiwa	Zaiwa
atc	Atsahuaca	Atsahuaca
atd	Ata Manobo	Manobo, Ata
ate	Atemble	Atemble
atg	Ivbie North-Okpela-Arhe	Ivbie North-Okpela-Arhe
ati	Atti	Atti
atj	Atikamekw	Atikamekw
atk	Ati	Ati
atl	Mt. Iraya Agta	Agta, Mt. Iraya
atm	Ata	Ata
atn	Ashtiani	Ashtiani
ato	Atong (Cameroon)	Atong (Cameroon)
atp	Pudtol Atta	Atta, Pudtol
atq	Aralle-Tabulahan	Aralle-Tabulahan
atr	Waimiri-Atroari	Waimiri-Atroari
ats	Gros Ventre	Gros Ventre
att	Pamplona Atta	Atta, Pamplona
atu	Reel	Reel
atv	Northern Altai	Altai, Northern
atw	Atsugewi	Atsugewi
atx	Arutani	Arutani
aty	Aneityum	Aneityum
atz	Arta	Arta
aua	Asumboa	Asumboa
aub	Alugu	Alugu
auc	Waorani	Waorani
aud	Anuta	Anuta
aug	Aguna	Aguna
auh	Aushi	Aushi
aui	Anuki	Anuki
auj	Awjilah	Awjilah
auk	Heyo	Heyo
aul	Aulua	Aulua
aum	Asu (Nigeria)	Asu (Nigeria)
aun	Molmo One	One, Molmo
auo	Auyokawa	Auyokawa
aup	Makayam	Makayam
auq	Anus	Anus
auq	Korur	Korur
aur	Aruek	Aruek
aut	Austral	Austral
auu	Auye	Auye
auw	Awyi	Awyi
aux	Aur	Aur
auy	Awiyaana	Awiyaana
auz	Uzbeki Arabic	Arabic, Uzbeki
ava	Avaric	Avaric
avb	Avau	Avau
avd	Alviri-Vidari	Alviri-Vidari
ave	Avestan	Avestan
avi	Avikam	Avikam
avk	Kotava	Kotava
avl	Eastern Egyptian Bedawi Arabic	Arabic, Eastern Egyptian Bedawi
avm	Angkamuthi	Angkamuthi
avn	Avatime	Avatime
avo	Agavotaguerra	Agavotaguerra
avs	Aushiri	Aushiri
avt	Au	Au
avu	Avokaya	Avokaya
avv	Av-Canoeiro	Av-Canoeiro
awa	Awadhi	Awadhi
awb	Awa (Papua New Guinea)	Awa (Papua New Guinea)
awc	Cicipu	Cicipu
awe	Awet	Awet
awg	Anguthimri	Anguthimri
awh	Awbono	Awbono
awi	Aekyom	Aekyom
awk	Awabakal	Awabakal
awm	Arawum	Arawum
awn	Awngi	Awngi
awo	Awak	Awak
awr	Awera	Awera
aws	South Awyu	Awyu, South
awt	Arawet	Arawet
awu	Central Awyu	Awyu, Central
awv	Jair Awyu	Awyu, Jair
aww	Awun	Awun
awx	Awara	Awara
awy	Edera Awyu	Awyu, Edera
axb	Abipon	Abipon
axe	Ayerrerenge	Ayerrerenge
axg	Mato Grosso Arra	Arra, Mato Grosso
axk	Yaka (Central African Republic)	Yaka (Central African Republic)
axl	Lower Southern Aranda	Aranda, Lower Southern
axm	Middle Armenian	Armenian, Middle
axx	Xrgur	Xrgur
aya	Awar	Awar
ay;C߁ا:%507,u?SmmKtUc.!ƄX1ZӣiUDw N$N5­ւ=tiUD^m\x~A.8F%6؃κ|hXu,eQv2p预6j>FpfX\s_~ؖil{Ƞ(G}"#B9Vnւ}?igփSw$:C=TX+pbCk÷:܅_V#>X5k3NyY )Rn2?v_~ܴD^)7"&hwgQ۬no9NtG{=w$!<aq=snM>=cd;ռ1qpEQk46n}/ڬd>Hk!/kT7>k.	1zǽwLld8+[WnZKoKt<{z 	UZӋ`"qlKzZ^A.ڡL*,TMٲORE(&$,to4櫏s.ĞsΏ԰Uy3Ġ.LpbZHm&:usfw`j`2AVfWcvFm	"l|&s᱙u03mo5CjuBI[[!M|4O5H߃x^͋E
XŃۂH"A
*$^mL31H0&Q
D&"z*J,^$
Z$]d~<vS(PXgDP,a):bqQ0f"S)п׽轋_xcD77-z1Fr47UYY-:2Qjʛ=3ɝ|9Kc"dg_ƍ~Oe!fNsԜR)U6ֆS턨JuٺbgTA]z,ZѠ;ݗιί]*MlD)AYUMIt̋'CfZbX7nB:G_LU!EZ0h ]//bʢܔә8)Db&wt\+|D}&Q:#d92
2` 77jo'1EdʢIp<Fʌ\2:W60]Xz/R^ ZikBdc.zd?!1RS{KV&$MOcvON #Cf1 O~Wצ4
3Di(NrBtI9UDBORE<habHO}.k!ƕMe<uC!د,FGOݦUZ0l`2Nh`Albŗ35w=4qP+A$:_N?;'Fjiպ)\$,J['z;j6e9	]fb:NR81&O>='g?;!sCMɽK@bқćY_g?!UwQI";K04MZ۟<-t6M՚ vb26Tj,n<z*SV8V)L+&#SCx^KE
DX
^z\D%> 9sLݳcM$((*zQC@	TL"hdw{ٝZ/_}S	6`ߟǟ?Ι=ﭽz~@,Al4O}ǉMygoҤ~ռGDDLY¨#Q.2҅$M\FR!hm~OLA4 Ml\2]@9Q=B|أsUvYehl"j%FN+85n?,lQv֐`g\KUË쑎}lTI]fUs	-?f?]p34'0YQv\YJ+Τ0(&sq໭kPeḲ:ZSMten&:<Nۚnw/ljF:NT3(*;a|WNV{~?9w3!gv6eyCPETQNx/Tǭcsm*YAKew}2*m&8b0:Z.T#MDB=5fBJZĚIEUc3)1VJqZc#-OTBtmQTΦZZc3!Fu[Sq>!"ĔoCRl&+}zuR0
Q"p-=t߉J/	>+V0D(.ixm-fKZU+z^as [;WoW~X߸f<'yzi'T.V	k7aV
߉6),@\	o|_](+WJaV(TK!ʺE]
tycNmCs@HCOl]FsmXw6x^KEZ!hAF;ԻDB\ªa#ƙ=zғxD\ă9
Dz0 k{853_ 'uJD'X!tk/\;=~uoj`9Ve˭髪eN^N4=Wp"؁b/&aBC.D=MoM[r-7nfBi%A#ޟ=y[b.ޠ3DiL4|__OdHM$E>ٞS8h+FhG	XP$]kd;&e5YXsgL6ϊWkP;#)Cۀ**ϴBƠ5;o!(	MQoT&3iCW^AB3X#zS;)¨	ByF-XhUڒUa971aUXbĎ-W#ajA 5{<:vN
q6iRhV+iE=WT3%y#G6*ʺv<8Mm(F4J&wnkz󏿶$)h&p`qVXkVLd)h&r3Dsɠw5Y@;)Y\7R[O8Έ\dOvITTD
O,!nd?;H6/Rd|5rιA?\/+ϼYQ]ZDb:ekI O_~`
6`<<KFj!3Mva("aDɽkQ;Rpe <M_&NehK1~jM;rn{YT+Lp=(܆^pӟwkQ;R[8Ś3kF0aTt]-W&/VӁ4'TYF#)Yt~(V'Kܩ7GS< H6+8؄q".őzxu3	NVoFz2=gpחL?Ea5M/DJUx^?UlZX+,$h8 X{͟ufv.P0("SVVh5HZ-$M|Y.<in7g2Ȫ$֢ZԪѓԔCEP! A8̋LK27WO#}[xw͗Oo&E&Ume1uQVbmhMuc1ʵɛA{ؐ!rHC߽X	I^S<UUa`=u^j0EQIMfrϋׂrCB5(Ҫ5#MY-251JQJSR=*/ɃI54Z
RS1֢?拧@Z*rҌ.E#F#Qcּr`	lNL%Y&cQ$4FC1㓴1vXr$7!p[¬>腃vx1;3hD U"m3ޚe_dɭ~18Lq	\=.>?'>v2ˊϤnYܤj&M01/tr1NrJH8DaI[\h*MPtzg2BuMP4p<wj#(,wC3_hM07ISW`HQ)ƫcVa@nlcKKc^XD	IYJ*fG8-ܵfe&8^8]35#64 uUcMD!GH,"W͠	^1 ig.uZId5HrGq4FK-=Hß^Mo=d'vdcRI-ӹ϶k4w>Փ;h]Lo@<ȑXmH.5ͱ;^nXK>̓7aDSIYp{O35}lǶmn1TP[5	00#;>/TMUCDܖChEDf 	vZf6L0C2s+Ύn|O̘ _x^KEAxH0&B`zu=Dda6j&XXmw{dEуEsգ <*$Š ^BB v;ӽ9U|4|Z|fa0bk{1bS0	,<`xv1FJ81kF{=K9M4hW9P"GXA
[**/׷?trtWg~@q $8N÷q]T7ا6- [@0)ժQ}zẦn":5Q(.0̙F`dߌ[!gTǔPyQLseפ#/C1Sv:_Nqo @12)P@$ѭ-mZ#1=Xs4KԔςH%BVRh!`(FzWevᎻo6ck_jKGqF+X/xcÛ|ic1j.blROs)XΙM4!g3S c+b5!xa&:TFHoi%n/=C N'\pYnUD'b\ȍ|k\.
V՟wʸSU78Hm#N	tuKyj+ѓ1g|{'3eziٜ ^k
f	ؖSVq>>٧ĠL	3x[].˯J{n+MM/xqɛDHIBh<:G}CŝMC=/>UV_a+s\JU|u;_WM|oS[TI<iL,F8u}@K%2ύRFvwo/%z!FvfM	/iFIZG+7n"c\eSX6)ҩְvKc`m|!%WJT5i9:3}̫ hr=F7dKx^KU;(qiT$JmL@&&Ab{t5ݙBQԄHA$FD!+JpʭK"ZUZ]i[8GzV#=rv4ٰ7LCotb}֧Ў
)cAs}>8Fpc(П_vg?`%OK]DxFj٤=V7J	RS@M<`Vډ&v:ȶJȿl`i%10f.BJ5Xr9gQ;,FSt1NR1U+x g7zN\@$1 76&sw'ݒC.>}x|y1G*LL0IAsh{ju'.3[eQ!kTD/+l2ov 
Bd
x3/eډ^!VMh/i&`KEJo8M=̪5R889	vvjݯN}y.CFpTNŸ]ˠ4f&x":U.~͛Jt:uBN:L#pXxP^ވY|oQhڸ\:cJQ;[1՝e:+J	"DYwÝEgۉމa5:;uSj_}78l6 
<b;#\)\q'2E`NaϮlscm"$H;C\ۅLJh&E󢹰tŸ22ۡt	q#AǓFw~xC\ۅTCB9U=E~ly׬]qU/nY%8]/NAo_Le.vWʒ}̿Hуx^MEZ<(x0GsP	U]-Q$Y$~@[j3ӓY%)HQ $	٣hw'5lax>fnOGWy-VVlGO`B[*<#xcA,/raR	S>ѿoS}Gu"ɰ687Węϕ4f2N9뛻ӵnO .Dރ֔x$3b[/$D=7u(	@Vf0KOXSF%xũT$ann<{pDҲmaT#"/f4[.S$b-coj._#C/`_hcgsVRQ"h"Mt%ĳn3N9	(BӄQcMe|dic̻Ī2T777e}BmE) fRzCUk,}W2h`8s|>ʍ2UsLN)g)ij[S{籷]{sqfϜɚ=#TtXk	<ճ7[ֲ>]a]4bj=pv6]묝	dۅӈQk
cXV7G1Zk[m  [PCjMH
kbu3X͕v+w+TFk0:D?QX,TWFhDt7<udl_2))J$$5aE^ֻMCWɌmLU- 8$evJflgj%CuRo}eRLCՓ)[_[}g|fKe)IWuÌo7^1$}ȶT3ԟ0ywBedW*&*g^]M^㗚/JE.x^ˋEZ_*aOC+% 1bd!M=73=qzfU" zWE!Y<,Gjwvv-2~z
|ū{矱gPidl'-Mi18v;%H{0,"؂- '-ܥ{d]-gV:0(c? 6 Ϥq=taԖ?C?1˳&J$b.v}Cw_\O5TBeb"P.%ދ^CbRn53b#5ezquϼYQxy^#GFw`9vjXBcx뼎B-)rSiF0N_BCp9]ښJ8r,TMs@!1urwVf]
v5+#CTiDtP^	bs[h|IRՖwzO0v[n!A 
Ĵ7yaBܩ͸ޠ_Ǖe=Y7oo%ϱgT1DaLO~X9Cb'zXE(^DZY}27XlV}ntFIbBx'/Dgt.}\E	vPoAm}V&Rk~/$99a9m`.ڣYh c`l5ARh	1ҔrMv#b|ՈKnF`i(pdmxv^Cbw֋g;j`˅<Ew3A</:%?ɏ<=_C<8^&Sð_3wW[wquQ*y&J&PXaG)yqu{bddo x7sVAw.zD\"8byU[+{n)ۆlH%5"ZoptHODbI9&傩}W}}=7lHpb_ZEx^׽e'Pny_eI@y7ݙuv3(WH )"@`D"Μܰ7|Y="i\gi/͒^|00ILX@5
N	oJcz=k?Nt+ќ5؟C<JeJǍIt>լn1[:p-뚸bKuXRUveیq+Tl`(V8RV7!UgDcisծe1FuKP%WX]>q?إ:-7 u&ڵ"ըjYǁ:ێ!;U]>t=rډޏq[e% =XbЀ9q5qauB|VG/ILfidNfi.t\л;UwDз[4A,'A.'Tvbc4@q_x<<	ΏW/VNt)F.rˌSfTt"ۉ>a]BTqÂ"^޿磊Nt9hG6ik|ك3ɱnμyԋ׉b$sCBqԣ%۳>A-OFy'QDWcKQq=%5 gpFbį/0bJü1Nt-ƸMpy)*%6McJ|zσNt=Ƽܭ]A--Ƹq-_ůLxF;L=Q0 !x5J;ǩN^wۙ#6:	a~2-W_x^OLQǏ,xc#2xd+Q/I^@%I%
;^w{yssϽ5}ki>}%^NW	n[&<gI}iogN 2HƵ#zzv`1IG猣K昒7VT`	`퍰Fvf`Gbr9]!n036&8؝D$^Bpŵ4\WaN[CLY /88V&؝D`A]uiե4]&T),fhY;y&÷-k${"$FITRRJTԷ~	D
"!T}؝D	̅jv-k.dT*@D٢wa!w#pj1aqPC"x{=cA9XqNN6QF)穓B\fױTVbwbuj	`DW5zkU*M0;Pg11<2X*DS4& 2ˀ ړN`8U|[xsܱ4 hXblIIÊ܇4qC,gOg+CJ<AN@lLYQ^_:i9\{p1GrJϭ5(pj1aq8F*6ZqOr	j)T:`j=AN@lN2G\pŝӣ6Ki\`)>!ZLD\ cg`hem,*M"kQqZ	<a?(x^KEZPr5(^";֫W3YPLPq;*x%<xՃ! DD=D $QY-kMs]y͇ЂY|-/x:47,CodLx&8b@pH@JQ3h`W&X.a`e\v$isdZ;+tp+D+|*MI.I4c
"O`]TZ|ĚLGfY%NzZ%4&4_@R{_dkݺ^?yD帢|WF%xA43N:lJ}C/ vN18`Uufr\qun4PRpL89t]W' AGv2u6rՠcrRP FJ騂%9[|{|qX^XM&;n}6\w.FN	k5DMior/a\ JV9R7nEMȡ>uKJK\h[_gե7rͪSzֹ4٣]4Ք>!C|D ],kOmu	XDE|l4ѭ˜]J$VU-HЅļaN|2ǸQq5`sA7˰wvwm~qEx>n18B w-3#Msإ:,pM&Q|X՟?Z;v&%ǵb+cz>Fv샷#'/m։~ˑE]M2DB`EK|͵ MtC/ vYVQ˕)-!k7A_xXNWhhn HLx^׿E	F($E1x=ӀA+gf.R)҉b "*ݽ.m8ݙ]DGQ[oDܸZ׉Տ̜bȋ(/8&gbB~p%#1b}y'.F'[>_D֋,0) Aq ^<!'?5]Mt*veW|WN	8>>BSs)iw{ڜL8tgwN`gN%ﴫΦ->sTj$1ekש=H(t:ϰQj)*bgSbt1.P\@*Wgs)W]>Al0Ū{׋Χ	罏A:>UDRXk/59#O;0VԶ^c͉n=@
+LPr}OR5'zS~:^<Q[)OʺVsoSە}ZJh:m0)8<
֜N
B|P뤣Tf7wis)qO:Ea3`\7^k}wcR\tW.8xfP۶~L![}eV3X0q]۶d~JqշArW=Rj dsܮPIplֹmM5r@@3&<Rv-ExPʐiȨЌJUE{
m;ͤ5
Ikz3R+O>7hL9QOl#߁)#qi<Zu 9a1/aun~PnQD~7Ax^OhEJCŶ:w<(Jbm6{/GJRfUzA/E"R1"EDl+z)ΛdG^vxes~;Y"Wp0GrC٨P{d"ٳlM06-kfg9ԃfjշ&kܸ髕׮,	Ҟ°5;AEWPlwfP;{3t?lB!}k}
sMp{+`5vbf:jS"akW4cT>l*χUϭEsda\10X}#cO{m/w*D(xk"6%K0sNZ
Sw.FߏؔѾ|%%a%ƥmS=0bS+](YR 4e})Oݢ}-Eb喵O>ѯ})\V-K)*&HH3qz1oGlJK:[a]$T-zjDօM	~=FK+1YĦ:DWìJ.hi
&61~_ؔы*[\PqO9AG(G>yt9EĦw^dKT֖CFi?Xhy櫈M	<̖!)M35~LNv)-6ūHrb@Ws/oJP0c^xfOEnJpG썊rQnOX7rSeǒc>Iy"f_z-rS]ݲcв^hNYHbܔ`O썢q:4#@VmdK)۱ZT!x^ϋEZq%zHHDVMuիw{Ǟ*
"x0'!] ^!9f7i\}aWo+еg
lkXY73=DD׉[^܆׳Y?W)/5P/$[>m1%,uBV	'43ԏs{7z}h気3g9oi$D7/*U{wjO
sAqMfϳOunhfg'όFo%JtߎIHY$#㻮֔nfϖ*;N4	&!0p,j}ۅ[%ׄƳ^%qD)cʰwE?6uz#-J`tt# n#6ړ	#ED0,HAC>G=,^m&12W>C=g>)_.qNHN3_5f#VEK?}nɢD't#aORi.@i
}?Mt`$TCn;I`Q׶0Q)3vmpSjUǚwGCsŷ<Rt0W/~}?AUVJg*Kv'6=Y4$f> 0G2pڼt񖅢gO;UTJĚWyZ
ɸk	[pQ/=2oZ:y6m4\-ED!K?꟞YH$ǷG%BҒ.IoTpp%Tm>GE{&zy|7
	mg4JPC=ZYDOd4لicK~L7vU G==w}4\ڀ$W7+7\^|WL*ѡ&rc<MAPY9*phf8ݞlzAsXB@E5l7OrSIM~y/?3W 3NZx^MT3 HW"s999wZx^gM.9a]Тԕ¢{B?ŽGFOn܆	l&?y˝?<z{ڗFiҗYaʹ2ycpB4i8)dx1J9k31}I~KcW;o,?8	wʄP#CH'i;%z{[(W+w̮gҹ~`,ǈkIg;qk'cښH餲l*mƵE+c9yOZͽ~Ve~yVGJ[,aؔw3gyi?{5`vɄ*4;}uYm\5QՄA1 M3gn=l#oSjq\X#Z^ڻ0͙*bKT/-g	v7g>܍ts\k'Qs=OrD:.cF%x9c~ky!$JLK;	z*@Ę3I$qL :o/v~ztNpI;Zyꅃd'8c=:dS˰S
ba;?ckT##v?F١b#Bmҙ/~kck
Ќ-s*Ic56G\c+$ee##آ*̈́п6-1եh&;ELGЋR`$Ԑa$ѝW~'gᾞB0?o,b:J-b!wNk'hy}9U!ǖ#\(uPU-_bޖy#wlQDBP"Hf,O"	>^ߎ,zaEv .;i9t	BֽmC?BQԃx^ˋU r!b5Qu[*aιLJUu:3$ABDp#FDQ%AnBouFTAffͭ{N#4x2r_G4Q4`VQ	d2fD{&رdLH9qgned'ƆkB'}w%G]:ρA沧Y$֞8/w.Ϝ[m"4K:/3\&&QIkW?.ٜfU+嘳t	 K=_?rik7GCfH7I37*]J{]ͪs40M@}ߟ7ˍ&^]ti0M>-ꉦWT;є)%ks]ٕ!EWfdhXX{OWto<[7v]]ڌF#(sSHhQ%$&K4&-ءMt~{ گYP( W
z8񅳛X)5+ʙEY{ފNtfdSg{/#BdO7(;|X߸Mty?a=qc<:Lb*_Z=lz{E4wGAUn͋^[X%<1N(vΈzǋF&: +*WNs늬CXV0UK?=Y{',	M8n߽n[m";DzaUAZ0a\,o_G?K5d	\2I8Lx܃Ơr^=7G/I~Y]GKncKb!ߊW2?Wu4Iu	Vqaa(`)kBx8EEspKTXtԁi<cvilG^9wd9ļYD7,Ǝcnص]ED~[S	w{EvJzNP!WOLn{Uxx^KE K"B]VxqhD6tO{w߆8*B5QśKP% x57&tn?}盯j<&ŃQ\LRm=O%{f8H9	QlD R;`pL(
"#fa=n}ʑOWo7y[O=SŌKE)mNlT%ۥQ%Hłł7̫V<T4~*Ȧeό[[/aŌ-R[j!Qcz[Yo/yv6SkZp)јWN]-*STLs4U#J437NܾZC 'a7^{rs[d빶˚io@K#p䠃Hݠ<{|2Sur.jH*kb1_z=]iXV!GAl7*\zaY+lh[.Es$%h+bl_b	?0ˋ_]:K7l^|YѳmV;ZrA+[NK{b^8hI6!K#L5oK.<{~t)Zp(ic5Ϗ]>]NGd_ysLF0줛;X{!Kx_l@ tt|:X	·4=})(46lVMOw\1/i:̼{3_vHvq뤫Cԋ'_˻]JK[󗥋WM|p 4Ųgf+1E;Fs˙M	Btn/r:)BҠ^=Z/vK!EyƝuBV8͘V5rF}b|R˪Y!rs׻ޯ3Oz]Qo.f\id"E1z	>xzx^?Uw`a؈ϼ)ά3w&6ڈ]#"%jc%N!Euf.,ev6ew7O|hN#t"/s_E;i2rI	vjJ=2"2b<KԎILL		X	fySMƄV 7!~F,'zWn;|7L
(eQט!TjIdSm0qыDr(_O(1E	b}g~ݟʦ~B̃EWmӺE{0ґرC9;OIz}bLj!<6{ޙ:~6k'pxSUgcI/^RibәK>;4r4ڂfǘqJzf^byp4wTh%_)z՛7OykK[*fѶ{ yjF`L:}znu1 MODIVV'~lY?!̇01H
{bT?ѝ!ȧ.O-Fjם_oPwLZRg" !]ܞ .)Ѕ"JMSĆz
R#W'.o7~!1 ۜ'!AYAkyuڻn?$;0{Q2j$i*C^z6OC!EZvcc',xeYͯr:/ؼJX< \R"	x_x?'!zKgPV<c \Iʚ=w6ccB2aASP<xj;}[쵏^X<Eo1{/[PIVo]{<':vUƘVi.B:joDzs(ar{ E
<Ϲ#COvVуx^MEZ"D!0C}WYbTD禙7
b !X*!(<{TsQ$C=7=6T.xzN2S2j6ҙ"6#WhWL	ҞHƕ%:Rpd<.x@[0boOd;~k,ƽ4{iT+`5o-x}K&|ܭBU_KP\Sn=}*[jcBQg$qcK -Γ'	!GU
92N1pU}_7_zWÍiǐ떐ZX\ Ӓ~bF&x7U}C&Dp'&%%or7}1MQMF6k#fLqp&߇\w6\6Ckzn8Vu<G).1Z=F"A o1g7}1P'[+E,$	ѝ->܈Sn-z[Y[w0kG>1D"- skE .<qӨK4v>TsMj6f7a0zkeJZ,tPԢw|Fwl~0rUd/a\O=Hcl#5l/͐?^MpZ+x\^f!/1!1!dB]捷^96|dfN!W	Mժc&VR%BhdҚoX>3wQf
cfX*1ٚ9g`sg/*cRH4&5ߴ`c&xoqRM3O?K׉cK6|[Mo'`q*SU(3P&coF/gN0{fv&
\?zLc&80s=
;_k1[,"<NP&#mx^ˋE Z  JP Y>(
`Pϱq{1ă 9x{C$x\$QDT%KĨ,KLRݻ4IO}9103#o*{Kx<X<F`FCpH4}#
CNyBs7xn\X'뷎<kR lN?y62c$BH8"-̟fL"(	
l_czcr=ȳddiv=
u8?뽇w/,Αg g*OtMIei([c̺Cz.֧#1l<1)2f|~d^	pA>wk}Aх6XiWXdbbas%=ܝ%8}~!X=.P_v|UZ-ZOy\?lK=
:Î5
@QP[O𕋷{6P"Fa x\xe@=a/vطگݺd0ۨ=pVio]a%$bfql(C}Ce=	s6k[	G4a2BykE;	w)scWr
+Gn,b	~p1>_(4DQ12<RLۖ4O.ʆ|u<JzmF.)=Lp13>vyxbeevҾuy-͆SM1P[@f>MpŬi>bE:2al x(D\O$Eؙe@&sF=s'savD"{R$li'<Kt:ji!0FL+xb4ӮNcH$G,V:qpzli.z$H<ڱqב47s]C=54&dYnW.kѢx^{lSUO;2܆1 FmK$=ڲvdX[;
#!N 1h"F"!"1y-m&ޤs~wϥh7xV*[3?s	Ml;fsY/.1r55lάA_KQP(aUbibRA,$Rf&ПKnBT,ʛO]o+/Gyʖ.C	fצ?3ٌ2 Ij*9QRc:_nD'>ތ!Mr4M5Mft*Iv9@ɥ\c9G?T4E庡*G.HikPOC1bds'8Rm=̀naAPEEXWGQ\9bvZAhdtШo9ז;r\=a2llw_6奻A,< Ey1^ثJj<NZ*Y\	>(G76A{A3(<AnqO#8n?jO"XL1
,^b+ɝ޸ X	*J@	H!!c2/ډk0hڿb*v@YKܲ:0˂!
`_S:¸lDXFEP1`*	D]2SW^NսX_U<7l]YK$,amjٓn؋s'oqa'oxSxؤDTh(D}S:HWrkge=QbRR,,KLE0kq TǫO=-(ET:w*V5-FᱏO؉k}uchŕv1$;XÂ,Q/Ov]:7{+N;Mαg{XMƕhsa,AmuZtj-oNz_.@j#,0.-D|b:&=)&xևk0{m}	w@]m MXSD:p	3F`~fQvkqZ_q'%wzEZڔTR,!!B#!tB^rumzg\ƚ芻~%4ZbT(׶,B¥YSD{~(UOn&l銸"sr I=a+TmyJX]NpyݞRl͛=6=xs,+g,0>>Q[o]75xv;xX͜"/jɅ)	HBDw&FV]h)\;9)JKCH2͆DFH.؁#ENp=뚰DIuD	tS'c;/'Òb6p 0Âx^_HSQ s6E#PBVdz*[PpwlҠAA=ۈ
 !?otEaDb)YV]GBp9}ĕ7
u{}bO5(kl^4K2xAGC@A7/vα߻3wjFk77|[_'@PGTC >dl:떶ZJA>w͖NE
Be/GPg0=§1@^P׿97+ŝ| TM9!2]ElN*s*6ҩP8;7L;Lz.	r@U>NXV@ja4$rq4tܺjutPm0wVQDxr]zwEBi#HmBջS[CI~frބ.?&ks	I>S39C8PC3BHFj|+2GRCJ3GWD!L{)Z5jjɯqmsP׼ą򰠒^7XƃLv\=(WJه՛4śChFo;{kH-|"TIdo34R%B"!Q%<V[`09]ӾM+%'{i-kU(Kx^mle FY,HiK,Lk^8w=]S`NHDlʖ .|a:?1`h-dN"²ܝO&5%Iݺ~ydVes_->ܫ2{-.Rxч+r`/OL,0F98EK]\dEuVUmE:)Dx	(!:)ЮO{j2̵S}w!\>jDA,[R\f̫.un[:JȀ#q͹;E56+?u6GOs覆|v=~k1{e海;M6WqUm={+7*3BGOvF8W""&xxJ]L+GL,(B,
[Z1!Å
@EڑCOKͺ/hc-+ jRfl.
S{ΕH32:p-"'E1#CAKWK'&^gt/쒽%	$VxCl@+u5xWHs㺫r9v%3IVSdyA)LTzό例*2+V8RdURXB8,?vǵHsP4u7
]ژ&{>wSE74ED	-dO˹-(~[jHEJ<i4^d\kɥx#XkVOYSݠ)X?0	"aKu֘]z9Pna)NKjb^AMIENHNdΏיv$C_95٣x:Oa	 (?oNޞ-y/Zse)H::xDBD93^A7|CAb1ڿIˍoy@gjmm64puc[x\0+HḎV}QZ9{/`H{|י.mA<hT,nO&d+ Pjey{STu4W:fr%;޺aRo)M߆"*VZsEx^ylTE mZ0@鶥Pi-˻BkWuw{)P9ҚA	HP#KA+rTCp
 
ΖNM7Loooa	b(_O>H9YmwܼR"1Ȝ{%},P1*,!V55-Ԇl%H%1؝{Rϝ؟¢΂Q1fY$ϋgb*p2mπ.zGPp2,PQmMtI3Z9i%wsy2ʞka Ya3J3iXMdh)h$|~/oCqM*i~${^F}4r$C"!ěN֨>o0}9:QXZ2r@QMNmmiwO)S.6dmy[⅝CNrG!Ҫ{m^=e]A"%oJb0c:#1GU]AU!bC*,Z:ŔP`e2С򲍯a`	&1hы[VVꜨ
d!4=!޸=_?le.f.QiVi"W˶DNБz:潮s̜llAS@6(=yK5lE71=m'671%A;7b-vj⏊6⫹7K"z%YPǓWda$K2BIӹZ~ VC!X 0ariK-#3XuXlh<.44Ze24NE!E2;6$M穼G<T[˔l|o^<VUxC4\&_ya"OyL!ׇ]/` Etwoyig*CU-+du(w;*A sMA38JW, Vdzk~N\$ַש5bk#	|u&wXzjg)`Yۮ1V?LQSlg<Vm'n|igwcU;job&3hlUUeWK^^ħ8mevh$18٧&ڹ-,f14K0lȧ}
+\(>ӖLT
2{g'x'4GV̌#[<%UѐO%ꏷX1uFZMXZGmsPH#/-umFh$1 wFr6tŭrs{;xsЛ+X~"T[<D5|(fO7Ա={\,TV<h>AB6a{]^wkd|H*ܱg.Re"0*L?L'U(7g`ĀԽLMCx^	lTEgB)-m M]ޱ{;lw^@(bDĊ"($
bOFx9Db J7o;0y1d3'3:D5_5E9p"pnE_IC操;
NKWlIbkI^;C2PaH/k\NIzq2;mZRU1F5CMiklVcW"_)ᢐDq5l!n]DtF흡&"j\!Kɧ.M(g&gP֎=m
_N(,tLmFL,p(l؅&	mۅւG5k<6wIl&hdu@J]v|pR]+IF}w3Ԅ'-UxB\ť1lϹHu=q7 jfd}>|+,aDFNǚ♮6vEg/Y6+^.Ȣ(=/mGrSA'>pY*w|UU&SG3Z ^5T
tis(*Xf[(AIYI-*ըt-}ӒdpQ@Xw%CS(ڵ0?스d6ٽ{;,a3J,Wn
Ln\:ӶJ5:7aV*uKὰ1٫ϓD5:wE|ǥ0I8$͐U] ChMh%mOnjtr3q+dV(ߤb]8!վR?̚cRnF*Lns>;%!p sK{W"z JM51Ȥ?wXt/ycK
qFSꑯ{kJ5:RFl]H.QsPO'VȠM;KT2C9j-W;ºZW"pQs&{8}T'.2eL&T6[`hǎy"fPY
j3䶉vEGeYUr8Bmoσ_mfI?8+9G{}렱gڦsjP}c-QSPfʴzu֬{Э斬z;hL7}׃Qq^ZUI14!bFﺦhқn\&XJ'.y.1~NQJ5~35j&8=v29](|Bx^ҀɦR~y )wpvuzQҺCo;mf@Z0Sc{0PP̨HFI,5m>tze~&o{	j$G]q~yEלilcj8Zȭ3tvRpZV[ź7f.(-h!eoe7d"+ֻ؅ϩV#`{v)]=A"/C^82tQrc8pȗE}@IY8ѼRx^mlEǟ@y	@Z핻]}mq{U,JD""
@
X	-JT[*PIhQĂ j-gK;&'~gfrV;'><]谱r$;rb6cT0"Q٘mb ~=geyÔWtڌi;l[woW#هG=rpfCF4/A<@*2\~TN+xtM#"pf2TP5GM>/bK_|fj2 ㎫[PPF\{9Qala__c:֘j=Mؘ6,y f%#Qw(yfSBb#T V;-S |ْuʊwf[:\u[7YNqLC(^Q$uSS;*FNId(`0NEޫ=^E;qrĘB*Ve:yhЄCa4
-Z:>o՚IUC--q`~&L&<K9ͤLlKSZm9fRUK0Q@0"<O83ϕ);2w2S~j_Si"1(al>FBL4z.Ǔn>lR&T]r]6kԾ|}kDJ]"$[plATCE#bC5o<:R:.'@TCrCM~2exMz2Vc*հc֫[: ox1:E%ѥu8R1ؑKec3G fH (n\TuID7Az:ͷƯP}F_GkqJKD_-R_2)#2B=`w*1Ʋi<*)~+Ö}b1=L:4NP#!#G<#Ad:Jٙo;\YI5T&KƧ()h*&Iĝ#ReF C__da^ľ_G#	k{_NRL5$0)'՞sk2QUG̟}jAde2'Xf֘Z|"IՔ%SF%(TaI}nڷ'Kn	>ze- 哪zj-QAyFaüGp#s]II?T3Zb]s:!a)poGPAܬGCHoomJfU.Y2p^LXήm3V-6&Sw$!|^R&P.sB';D<[OJZǭ[W:Ucq$6,5bJ%xͫ41Qhv}"nPM57Czo/=
yx^lE ๖ZڪK-9AZu]luؽ^`"@j5mH
bb"((C1س*	("1  89ĕK6?l֣SE4AUkk4??Xq^X:˭ؼAו_|ŗZNט3(aF,"ߡl1sILb-S 'CsUAQ5..jӫ:2~n*4uGZ̴yMWn.^MO'Jc0;'L=T"6fVa96V,$&f>m-0d[雪+񐠓QEe>31JcjN{*T`DT'MȎGu5d'0uZiWDI}SvΚӠ1x;EOiT Ac2@_+byAOֽC$V:A˻2O]β"(wQjn
bMp
n)j#gWpMW^BpP,M7$dlRs:-@vGYsԇ y2K7qBAWj}U=;;\`٬7
.B9^NZ䍝
:j۴tTC^"$VZMӨ|təOMcb.Z2.j:ǊQ+v!9+	-4Ua 	,X=7Ϟ?sM+VmlW(F5Xf^$rcT^/'JV|đld܁͞q!ެAEradq}<x7!i>q_z-a%]Uh@ltiU;{mwTkcƠUG}FM]RD2(ms7Jcp%F	9TZ] )Čxr4&!~ﱴ.E	q:o7b_	k/TӉHcP͊)7ΊOXS0CIUTfEu爺i1f{Y:ؙ%2,Z9
j,n#qYT,l9Z"~-Jtd
am{SLY6Em+fAɌU>AX6UJe\39#e[bK<?Đkk%Y܃aX_}˝i<1Kz㙃	C:0UDՓ.!JbL|1OꍧA)f)5uׁ3d1o1Qbjf3i#̾"oDP$F&uZiΠm=͠bzR٥w%A_L_z8C,"<hb쎊']fc1J'vx[Īyv-Kj63C0>}3ͬHM^#ߴSշ}5ʱJc0UR<̹S52ϓ?|з_Nca}VѪ5x^{lUylۥBy(3swwvgn&h U`mcG)ϐh?"hi>b{g{d4ms9 e.aѐ:{Q*BIGAY[3#`M}>(*
_3`uWp&XB$!6)6LERc-h`3-e8ÆX9X^E]SE=UU+߃^iW3؜
G2`+Gu3pH*r9g_A?B.l^ozqf쒣J@M⢇)@QJh݊i_}\sm>S.M/wx4zy^(qk'g`RSvR\lfuXqHش6USs~nn۳.<^^V؄#Df(Oa!hc׹Ik(AZF0t\
]V|'fn}t
@Bfj,݀34)Aɺi(k5ǜ=KwQyReZ*c,`xpRX:J8o8xWUԝ4'~3pެۙ:X`G0ATF%:ZkFѤ*>eY)5Jvs"4׻ꨓ܎-	hU2\qxj=2o_4zĘ~ח;s!יD4+mw9x]OO.s}Yn)HēFJHdM>Dqqe?Up=/{Q aԚA,aeRޏ޹A0ub,RXlq#'s*!MPy,Jعk,9is`U
ECFb0S>/9Nr^T񷼂hRW5\ւ6Wxe2C#./ipmT"Vk7R*f!+LG2$]mΡ#{Sݠ6	Z$}2'~ah)[8%$}6&4ZGKDV\=֙&ւ#<m4GXHdUxz7%Ybrt{&\~M|rMY% iDY8J<qcsbAV3^Gb2)*˜ꩢV<Jc{kC;~=R"0JZeFȤ?3i0eD:*{/ђH$s(v^.2n- T^xhz`jR1{GlWdT||:/˚D^~Rr as;f_lvB.VČ֧ۍ&w2_)|ÕMX|n(OݺχoOd'WBK^r!S^A#j! dD+(w~uq
K}洌w1<[Ed	d-9;|Tx^kLW ,BZPZn#<wwewyXTZ[h-U*(4FMEcb6hkSMԶ􏆾gcM&''|s}@x0#\|کGCg YГ:)%CcH°j8(;j̂ ț.~&$ϗQpbwf
ADFcpIX=Eԝ|i;fiHkWP%~ESjQnN̼ļuJ $h2ifSZa815n݂'gYTA*ɡg_jlJgTG2ﴬxvL%WPwZHV}c7p\:8ՉTߜ]p$9|WO-UkfH;QHegTW:a>ڡ3nh6rJ@@!NY7yo6Muh(y*Zfzh[o1UС<9RrZCXaCn?PUա
AjXf^k>)}xnۜhnUEbT~4Q=r$\+Geuj}vFfK̊;/ag(|AQsc*bex^آIQ}Or.$%zLzͭg@(3ڋ'sb-ƭ6Ue:T
I6h*O52ŅI:AtzϚv(~Ee)a2?,\:tޞjv*11:3Ksi*Hw{.B>=jB57ɔf[@*/&V6	7py<=ىǚa GTt:ӝ%um;|p7ܴa3 8ͨPa̯UNB?Jbi*d=}aTU?Bsְ|{t)p8.Fq(=5d]'"ɡqjlMMSfűBFNQħ^~ߋip$&{uSc746%[_&a SUs,EM8ekO-:BsUo澈.Y4H*zvyWf|O.K7h`R-5vÊ|(d4җ<޻'>VCrn}}ca_8WuU\"ËRngӿ$ɴjiBmDJ%XEıV	._i!9tlnM&@`>TnNa:Ft׽Ƿ7FHړL58X8	^xՍMs9[?$^)h7ƇQCb/`֎OdKҥ&l.35 \~ua9{*YG%$I:B>
dOn5Uh@GO(h|}Ȋ;+GEs06;^e x^LUU {""&("S|>v?X!e4?͵iEV̩ᚹi4%gb-\fs**8;vosL>+#~yZY.2`Y'&ѻވ$Sx+/C?μC { ;$E	DNYyUG2[jHizߞ"-QUU]mvR^f4Dez'p]fRSA4UEQ9YFht6MXTJK4ufBI7_!u	&h]rىǬDk9i??UÛ[RXҘT+jA]uS\C̈MfHrJ6eXMH=4o$ֱq$}+=fMB$tM#+`F<KuHM;tAZXAw˪fG?am0"fIh`^<n}	ywᕈ8Դd`Cvz7e\ɉ4B.<HLw>*'(*a͇F6,\v7>FhɭI7Lr}?~vR?|~Wڞ{yґ)ۖx($kˠ~HgaPRPI:\*R%\+DyVshn_:h5BwLՎb?z4Q\qI<ai;Hrit&TU~@Xn@ݫ\lldQMܛ&5˖UUW8od#Bat|eg36EKoBZ8RlCuv>{m\7IXTgٿ>"!-(d3[m2X'A_j>lm+AeuAP;Iv́OT^Q"F=|_%9@zknMPX+BF:qڜIl#3;?BoHr1F'q,ve/ݼpN%h6BV|#9MvZB]C
BO6fhiqf(4fKyNSd;~"u$;)լbbUuAqh($ZZL%De+,KnNPMzrT78LΞL@Xp[ɾ535գ%#lvnłO iQ:*K	e񭩙#T/L`{pd%<^P9sEhCn'FqmMyHri15w5qL9pnh#}9U4zi?w%Ӻ?`	vk.\v[`0gEb;Ti˳g8"zUwQn	"Xf]:}avɦ	lN,fmUaJnwթȊ\~}+괆o/ɡSzO[$yFx^lEFP	^[Z[ZP=wlܻk%ؖb-%H@01Kb#PX **` L m(h ԙ쥛]~}}$03@}πV7,q	MwfI9+OG.i,=lA4BP$ޭ	U_v޻cZ
|.W[!pTL,MXx
Vw+17|z[fA+ukNkuXEpqʚW%S%1_W9hunc+q@F	$I
TJI(ŕx|N'UmAGҀeu1j!*53bMq%̹Bn^C ( US|rP@3*.hcG]*A!6|W@F[ۛ@` )5 j/}.BJ<x3EM}RQ&X+i,,$2¸[J<V:AIH-h!l1|Gng̱92QnG3$e	IVyBVѾ4`-Lm+?ت{hUh0+BrDU.uy8c  gFu^0VpMⰷ'P0,1*I: 	8\ZAHaSa0,ʻuλChsyE=~c0))蓨PKyeQ{GjM
.I`ijHH#(b,^<%W jSѓ.z Q8$𺄘g9js UՈ#Dr #Sy:1::ڃhwNc):L6:'Y8RQsV
*:ϰ}EХ6/@֞k)@`Y jLXf#0^ljhGjQ3J<"|-r:(	2>2;ͥR-xԤ36WnD#(/{5齸pF`zz."4\;lHۤ%o"tCϮ2.j3V06"9^C6os|7Kff$aD|4xSu]g.-@L<8^oP5mHʩgP{1{.#AI}~
5UzjEPЭR;܁XN[x
x6h#:b9xQEWs$dX{:鰷\B:+xkɾuP_ȮăC_Q'KlA qW3˭S
+`e<#!*Kq(~/SZX`Ɓp(9>]d=,amLgqh
(hr"{-N2ʠ
wISs#menxpy&v!*t	wno xg*)O*(s[
3x^ylUAB.3m!"		(b!?) i(6A6EPJCCb-6TߛkMny6 _ǁjj0hjj0`z^E-0xͲ#cK_x72#P~uv&d?r~(fɀrls.Ό:yWЈ3(#?L|'*sU.TgwGּсFÂ5	~T:*Xժm8Qfg=6_Xrg/txtJ%[`N74C9P"Tt@iTS5FղX=||/\ŖgPjPZ5u
+Vc8loѳ0-"w<GA&;	.`hEQځbu)=q@Π29	PgFFQV@f*֟:po_/,( .&ɠA/[!<_7#!MnVe^T>ťT	}P\e)pD;o](U~s4F3>;r<v-(yx8D'M@V3PĎ֊=T[X߯׆tӧT}lՐMD=m~"qϣrqDÊNyt`鲩VD|7db1k<#g{d²U]RNbڢ,̟]gpx7q	4 G4_PڪJPaU}T-q/7sޝV9[r*<.X+ZyPe>[#XjѩiF7jImvlHJ{I	M[4
,`cu]ϦSh,cc2\VA(PWRn%IC;p&[7!b'z8$L5>ÇNMFcbA󭋈N\t'*D*6|4=kazaxsi9M*x%q#Ix>
_XUb5wPjUвІ\xCmS:\4rNPi@0Uz$QE2:2VBō(x&sT(y^Ptv8.RM̸@Uj:0#'l#W0-y.Û9%`TŦ*KVunxtΟ&խxeVԁ3(D#PU]8NA۩o
Vi-<Fs3hL?Q6T7Ōl>gYo{AG^W@U88G阬;/u+!&SH^FЬ-xYGS֏3Π{mJZF|+숌	м-a병1[GAӾ9%6]z2ú6$֍&vEDt&~xjXS$A`EoJXYx^{lE IIb=#ܽ(^ݞjöR#4-$ bPۀTEJ5?FC$8)tdu͗/~;T!@F櫙SGtH&pO1{`uGAU_v<#k*;=;ttq7`DW!M塝ce!uF:QSmWmQ$<Ƽ8j.|.u:튝an]zZTNV:$l*SbK;uMc1a䠚f=Sa3}FV%V`xrw]ꏐCGpf:=3.*7x` s6ɎԽf6-9!Rk#A7vdץ .Uuy`/!_ogyGtDBoo#i5&ߪ-hZ$4NEK,\k$͂;xi}!КeңlEa8,B]?VWQ$981>n6BȠLճMCزL$fV1sKmNT)a,KW&!Cȿ[tFh:Yo3	ixŕiEr}Zn;Z,'!#pۜ5vMqfX%9ո]kxFKoY,*H7!qxi"9x(5,=qex'+

^ֺ57!dϥ&W%gZǁ D;͚Seh.l%I1N"?r#A^-c`UX'u]6u:<?]]:GUp7CKZ09t󂔛w@8D$P㳛x:Tx4$wэ .T}]RpS]oCgbJrPki]E?
a늢b%AGӍ{Q/)QBznG+㹿D[e>cQ+ofQ;R,+pk6)_%;2V[@Ȟmqạ8YOʗumFGU0T%ZfvCc"; fcj;(=jo.W'^JKHrfSvc.+ʒU%tmH)9CVh5vΓP/amySVn~ ,Mˢ#@	PhWUrZ9*2[5>XkUzjS9 s)/J%f@Fv>]*yتs#kUv6𺥀TDVނ)v\ιZqTl#רE	'~5UmҊD$
CO-	<PyH:!e,5JWg*:	U9-ZB>k4soNՃsFן6trF\&󬝁,>Ή~m4tiY_3?@{9AB"C?@R}M*l,!ROVjJ]D1]k?86^)x^{lE + ZPV)0w[pB@c4-X@@SRHM03
m*
H(1gv;L5Yݤ%M~ pz\ =J0UԦj~!,b xU>p?q6=EWu/*w?F"eFZ_V
~֟j"OpJPFQa"_oGEwF?sNUjaA*M 꾟c>6LG䠁Vx48Q(fBM4IUnAӳ頺Gu^=J4U@*Q͈+2"lG>)_Ӥ2{Zf`Ps+6\$Qw@E,!h]dZt?QJHL#2HM5kXiQoEW;(IMX
\
VA؉[m۱؊$yKhRlg#͑Lzi̊$^eGklw%UN ߳bX܍-:wxVzډ\ 4Qe	>{(́GHrPJ>Q^Z6aQA9ͺ:4`D>fYCͅYpQU3V,g|P1i=g}L*m*wPDadb䐄]=Eok"[F}x"kcv+0t:A~}VI\K}yF8AT4CHMdp@|$Bÿ:Z,>#uҗR1P54M-(r!ogIms)Aqu
FfFzRш`  DQ?udZV:i޼QGyAjn:*,oퟎQii\bfwƑ`%|rG,$ٵUI33x+`Ob(5nEN]fSv<
uÒtӪ?TRs}Dx))[_лJrpj;V(tJ4Z2ˋ8}s_^\'9|*r߾0|񷲳qLgg}ڌ$_tgGITk12]-]xkB̅Ugks}7{	7FOs"|u+@hrDCt)2ﭰR4)_WB|->2wưnd5VIi5g(B= KjTKeCP	+a<Dmرn2m	̟T {&Ѡ(ic#0J>b9@UC/r0y/79_[`
{9ZlHʚ۝%4|=W.YAI<H/ȇDG2xL=*԰⃷~f:f[(:w# 	>x9򵡄\Sαv$9J5 k27aJ4x^{lE JRb큠w׻^!"ThHb! D@Bo`ŀJxjԔFE08׹&+\&_ryK.^EBSP]e[*/_;T7LM~ti!!?#AQX/&4JEzKn*U1mf^æE(TAQQQT.̤jEԧ6`綟`֨j{tca8U/m>ߑ[];4k!xmEaPEiD2%#hcaR}q4wlYE,n^èkWaeF&r嬺c-z
ۃ77RqRV
*V߾nXIX=Z^M߼3t4샫nak]n[zQ QDA2P4ë
38]N3pgV".9`?iu_>魓$F4ܴT
'"Vǝ꡼2~t!QiuL݃;>`6fHY	^͡ZA^!sLc e}ʖAmX]UFώ>9v7KbA<A\[WRyIT[][KkNzKc3i_HA3DA&}tCUg,iD1̪}>hkAF[b-C(rwU|4շ؉U:/{!Sm̥ꐫ#bW&YG-ln?<""kN
yRiJ[Ry4B-r<)\U=rpc29]1X:Î:
AwC#R^QTupwl7#*ЂAƖIAUlVdz5KHN|	+*Hcv[틿cbC bVLXNU7>7㏶#\mx4mLirR%^=@1T-xN=.=
pٲR7߉Gi{jPQ싄pc0:3*p)4{fo+lۮJ`$H>"y4ܣQ՜|#ȽǨ}ek@̏+FՌz9Lשt`>jHc!'/vscd^It70:u-qT:/k$jUW"X(Azj5	ZJn_كv9i</9[`+g&Qԥ`vl]gt@DJt|z5'U|TƎ`@;SiRc>2Ӽ̑?O9 ;,η\jX4U##*lmHo'\^/&3V=͚EȑqbŉCDeGJ;3~N kN1{Vǖ0j.._Mx^ylU߶rԋ@\LwݝAyݰm˹DQj
XE$x`!&kQ4
ZfVx$_~M>zo4L\ 9ԀסE*󔂶OKcҾERZLo.~\N<`2H .QMRȶñB%E44o+Tւl9y(:X\rEQQmRtdryb閐_gSBZKZޟ`eFExHdvR(ZR5=>d\G}ptYIOɾԏÞ\nA MK;P.t*P)El5WmX9AR8^P$ϡi1ry4]en<;5q8&iRm7CI ɨ*A,.[3zF' wS2Wk瞥З+.,"+IXhes'SF*B$H"xfmo⌳,We<MhG"#ˆ JB S36#ɫX͹X=wQsgmfh1A	SWgZ]^4ޱio]cv$+]8BKš?oyhZHS5SFPflm-HF]p-؜_Zzph Hɀ%Xk^vn:5U<UAIzcXm<l:PunfꃷzY\Ytᘍbj_5S~*uxFSߛf^TFPtUFö9<AYDȊV[}{LB cD
=\hLRWO4TCӴthfY!]ZfbQ<r΋=RbС Y"ף]nk	Kn[[ꃊ[lw}t-"E[l;)RlgVV$$ӌ+_%>  媓Ca-X{*è!1-֊_b[hS06;=- Ȏw[U(>6bϽe|B۷WDwkd A!Тc9+'>vT*0fvc?-2G-Q%Rw7A)͓Nbn[ԵlzR_ ꠅp{;.+_ϚM*<RX>'y&jT~ /TnLM'e-(NSՙ<%x!a9TD9CO{.?؎)6+`r?$) QIFQTK)tO0dQ}$R4uF)wUiMC@QBCjւҬ1OJG;ញ1HL<bܰر<ܑx^{lE;ʣ+X>$RlۻB۝Wv1HѦHR@(m%&J  $!HRmOQL9nHV2&M?l'm0*F#;ZD}MDƴPI<&BѠFԺDx9EuK?Ѥ哋%m7ܑV:xIV~F.ꘖ \v(5oNlFϹFu#j?zif'ID1U%TݛZW5~#5̽Nݢ|oh>g،7u<iCRPT<ϻ=>Bq&.,oU
LU9aluMIcE=~/Eo2Wu
,":N$B9^𲟢KZFteQG=aZӋڅeKL}dxۭ+SNfJi7Q
{ܩ!M2Ke20cV(JXF}e%v&H7Gbi[s5{ׁ2JԑNXzs#*<%V7N_o{fLjR}nS>U1u4e%,%½ClkC$-SEJNoڻMeThp﷖H'EFqƲ"἟5_ ׎0:ӰL+tET׆ *3Fcjk[WBGGѻFuf5<}~U'Y2"(NۆW2mR?*ʵx948_?3O˭etҴgZڱH"':=^I}8/erl~(eh`uw,-r%
'z@}v:'qߣ.6y₱]u-9܅(nj<V{5 a۲:wnӗ6\vC~+(QB/rJ,*"\pz}"Se߃6v*:*JjH眐x>hsMQ,iXZ9RDQZ }!=熠ϚЧ,Z1O/2pK׮?Άs0HEJZ:W+|˟/HXFF\qߠ>Z(	XWV7`8q=qN>.E=piS'0}ۀ,Q:,<qo<
j*m:h,֕;RYFFabEXT	CQ-a'bWS1qukb= ծ-SS
,X;3m+RbYF3EkaFQޓW qGzOХGJG͡-e0]{68Nx'z|n;1fguk|!hq3bEΥ['r̛}E`L=se0өe7ܟx^mlEzG)P]R(/ޮ:;;^ۻ AZ-%mAh[0(y3*|m4nh yf z\BKD*_TQ}嫗>3^}J*YL~sM`!UW,CM5}B?Cmύ# üUZ->$U9~]\kYi)4une`@@͢Bhy3NPJ=8A﩮kNf>Gq](EN[6~cF
N6
*)!y"8e?A
~IC~߯	r bbpW3gyPYP]Qէ"=4BW]!J=xf|wW ,LVA
٩)u_+L:@zf,R7JvιXXN:V5#Rgr.TGpO+XTzɦ)DGHwle]Jlj.&Jav5|S`vORzY,bQ
qڮ_HĘ{wwc|=o_?yJ셂Jfڻ)øEuJf0`0-a8
ŀ55gU38`)5ڛ[!TEçE/"]gSgco_fZOzP2'vEy w4TUU)o"B6]9"J=Xtq-jfbX+#IUՋ{(b϶Ăsgk~J>ybW?բc}ԃ^5G5W2fPh{1$W?AzmZs;0cGGKdk7qE;J=Jn˒z*>_Ñ
{#EDAeQW{6A	[Cįi	5#a6/2~ŋx$5J=L`{ü9Tp$"0!kWGTI?ĵI!7YeDهp1X5Qe*!ͤЮ欳pulo'Kj;.`"-`U<۳J>E201~Rd|{Ȧ*xkVHAjF&6%ҺbȢRv5:E-/4q00dAry's.3XӰ?L>T- ~/Ɣ*fJgPi؈WuOHHqTV'Y`Gsmm$JEb4%<+yЬZ_	"K`n7y`4<?:Aze}]NY=فSf^0$--6sQkC} XB	縲8&XJ=8u&f<H	+wfzE ,qx^lE ^GRKQiL_U={w{]@x$U	/hQB)*AHZB!ED`""DR4v\&rw??̉I@d6jiQL&/o	[Ns@,REʂCr8Poƺu'=j-?Ԥ3Txoꬃhɡ8 ;2Wۺ"_+!)&ؘﴚa`$XdPSf=3-X{ W	P%j(\'Ȕ&:nI#s;#nLǠ'H$bʵrQ%Kz$u|!WPS_qlmU(}*Q4وYoչ[`v%Es3Ab=/ؗs7,Mnݻ[g>1Fq܇MCuV'eQ<I}^3d$n!`dfU-TnhN.ٳES@-C#Ǡu-&rȈN)H<1֢.XF^)v(Eܼ"24p48#*<ىmMoWLU^ E4Fe%N-]1TT3@Ly\iEQ{7^{ Zq.Nᗶ6[+K5, Jy%
H?Au	
pfV~|zNή7AI1SnQfZ\jJb8r֓Tke,
yCa>`̸iG:F J|Շ.3PxQhe(V,Tc0ͮ?A+ACeSd b$j=Δ7܇VFQ!;udØc
zh;%աzTt'ؾ$h
yN%jYاƥCpKRτK@@_0,Bax`c|f(:ZFiM_iʝ7qj/}ԝdao8QAuͅփۮ fK&ؔMpҚ7Xx`=}[ܜK}vd-~F;a騖|Jf%u.<XyGv1E'F]3ځWTH\A
l[0#g7\qj(M1oS}e<}>aviZl vюKZj8g9mlf*9\>uMМ.\<=YƠf)ޮbA蹮,$k➖
DĊ,.~%A?Kr0YqbՈ\B"̎(S,ACzGfR"JZ7@%7t|k>Tq|O7Uq8KZ9*Ԣ24JjS{Ce͆'GD-8Tb뜙̠[`@m2Eh6NaSk4V>31`fRfƴ5TMɬAzv,dXljUV|?Uofs7a!ݬĠ魾M\n?x^͖}LUe\$JċaЬ{uy^#/{.\Ȧ\!wpmf9g|-[Y(tS6zq[anL6H螡;=>7+By	 <|Ӧ2;~
O b$,#EXΈ*QXmVc)k2@pG#ԆI%>'ЭziR)R̖]Y݈2#TɘE|4!|ͧ@@
J[Y	YE#ߤh)I%)<^ w)*?ڲGv[d4+HM=>^dɭ ȳN	3Y9x5ǶFw.J|b;ALNdWZdǧna%T5v{0nֲ?T%>5bi3c"^I!a*i5Y]Vފm{q\KXksL_xإ4mfruLйcU!!U{r5褤P6Vڭ*aEhWFB89rT%>8iXj]΄J疤Yf׶n7K"V]SORJ~\6cEjhLVZC.uIwn	)8,Vݓ',{XczV~`bח(tZ\<}G^k9!|l[
WJ|Hmfbǚ vQ_BEJmLiq?͚emL]K<Sd>-AUW0}KvPJ#g>K|/VТyZ§h6*pfo&WN+*,U۔ݓBMF	عfOk8t
Ư\
3،Bp]C-z1n2kW_e9pGRi_XħDp/RJߺ?/R!vrj^ghC#4C}R&X:f?_Гm[,J2Ք
Ɓ8`SXf󖀱<*^곊"S
x@PtOAw]U#
xrз>)jms@< S'}yG? 3?,y7>eAB.Hc<Ag9E}Ч7Ey.Sw5G#
7}vHޮx^@!( $3/ݵ,5X/'?HA]˗eĎs\fl!R2f3$}gdvd;#筌bՓ>7dϐ12!MGesdRY,?T]XZ᜘TS&-	v:Dtdq⒠Ԥp@8'&g!,r "#%vN3| "f``7 VM2fDd"CΟ=NDXM$HX,"PNĒTU-gZF\Ed~o4@Z*dd_@bȼ&0'J)XDl*DdF%Ù鿇FTB݉LQTbQI.y9)-XzwI"h7oQfxG".9eE%U%y[ns0h(=r8f  G-hoDԉ ɔ$XDlD%>5*=cfȻKd=ƜG*=="!(I{XDl+"P2c`E?V) R,"6H1\F}ot	 hěLli00!-0q_fWQ*ѥ.Zk%S` 暧KЄx^Leǟ+(l.w @YYtK[h{̍-1l.cF	!n8]:?fnňf4G\}}]ŠѻF@CW&X4C˜H7C-4aM<!B]">1(QbFA뉠+Ռ&&(QyV3~JV~+VoN/g3$<.b_nbG2aoýkĚpͷv7R: M+"}.?
z'+27IԱpnUEd6|{w%e@ٱ6VSlaZog4UnنdpyDnIM6Dm	`o8q
ug`<qX5ulQ߸>%3^fi=]]&
g3aYJUl;f~Y}*Jk]Z@oBFMNP[dV!K?UͶvGUϦ5}AUب8v[;JuXm.XVviGf+gcN7SmHdDw 2;}81u6盜B$j&BEob	v?p%ڼ{ZRDu*Dju8Ӎ!ڡYI:|7D*^Z?>);N//άGK^pv|d1YE eWwrxXRМSrϩh9Ѡ{Gs/KMﭜԡDJX"Xzc̷)KڗÓ6?Z'$eI7[pJmGmrr(*cSPf2|tQX|FagT&/FmnN%*#}lGxMR?au^Ȫ{[Ris
~)%%'\|ݧ/_ߏk[ ?ڑZRHJ+WPswz?Y~=:##sw66Lڄy桤s,ڙ"6QMUury ѐ(endٵŶ80,ΦV$砫hmƂڂJt~s$vd)uB[1*{Ea t4x^VmlSU~O[a̱t"6=)	AtD	w[ڮ2"1!f?2"D41*F
	1V:i)DNr}s<y9fXb3rBi:,wƞ. O9aǱiEr;7޴2X&\,B%`5wI*n	[fZ]95"\$'uZ̰3H%RoGTp5û?h3UӂJ-:jF^D>Ts$:1CS͚J!ng@-5n;F^hOM*0/0x1\"\,n'bn(MLWnd1H؍d,JN0tOp@GUC,-߲JU.&Nү U2v:$iaL*!vǓ\Tiq9X[sDmvrAqJJ/pJA 1:kSX;7V,cIgD6JMp`a0&.'Ǩ~Tֹ}m4#Ց^`x/-+*w=I`g-włQysX&RHDzŨOE=L-l#eò6hT@4J-uT܌0:[n}nRCwoо8 /7CǸ;Eա9mvUpwx`d4؆~t O}h5tT#KCg<IMǢ91"fў+*l{bg(9ܗ2&&ahrecIUXW֛S=+@ao>~CVyACZz驒ѰxVIhP_dWg+BԺd͒jJMu%Hcǀ6A=4**V\(ӯsD˯	\PkQ;8j~pڝ7$bx^}HggmlUd-3&6QWG,{AnzƳI.ڮlnmֽt@pT,R:Z6TRXisc;6<8<V3sEU^A
CIPۖXO\Ya8:Eېy<G&z)q(NN5-W>6|abB<'6,áfVpw{d|?;F
Sgyh^߲c|DmH%?)A_yoc]'{TUe8S|MMЛwSڢUx2tz\%dISBiy]67Mzy9&L,\b,2j=l!Ia<n;+ݩ}s@59[x문_TI4
c?JOF7&6pZɈBJoS'h	d4
 ȷs=iĶSLe"mi[E&6y24bq7+Vy	
.k]r:Hv8Z߅%T
VNSbocgW_UXlZou݌==RR+gTQ$(\.gVNM%=l#\Rt	pR;~9K;<jyI+	|GJ ~TBOgUQՙMtiwv&͏)nCnU]~,upɳR'˷S"z5B_'L9TLt;1tita

7г?7j'DNf8agbV}G_@;yG5
ncL|PH`y3/OF*HPuB'n33sTZBD
g\#ig[~N]6lH5Ezop})
^@]`ҧMLXhiyXU=;ox¢<};njp7N{Cdl[JXNVg*ѳ:RqVW{*"LRt&T{&Hq9*-6{$;O`5x^}hgfImdFe4
s
Zj-j6=kzmrv脱فЁ
[ cҁ-*kšsc.d} |	<\J7R_6Ue۵t빺p B"ÕztַF7|Kx\
YVV:<|6<n6PaeLRvI"Nh$ZtEa3sSVx8acR.er]/ Nh#iܵںLrXMB.z!!uQ!,7wn~]w >}r6RJSsvq2iOs5092uRq?\|Vz]]<fCFw$%ṾoyS6}~"s{.|9ܩ
*!1Oyb[~l8aGSl||=˃_ZnAfh24},Y^y?40Xs{8$zc5tt%~OT YP5C]-vsWVXD0m%VaIum`sA].0IOa	`ëIɆe#kCn#d~$}+jRV8AyrkLۨ`^?|E3.)OT)C+JjU|p2eLXuxb^جV"Kg7ǘק?8!JA@dxl"	3$ܩQ:;x;*7N``׵hƄ+?"kTSõ>	%L;`٘ph*n3i*EF&灮g(aRcUw]O%Mo41'sS&@BH@Yk;41Z}7]S7	IriMAߪ%~gkfcNcj1ގ.$Kw_9^$TQKxeռ2i&߀.fx^]HSags_fA7R26J)%5ȫ灳3=;j+&"("$(H-",LHEeDQQdʞ}6y?>s:۸VFh&rW]{Ġ]ZͿZJ%tiJEN4)5+=ҡ>FɣI%;zlR&wXG$z	͌66QØͯ٨2ũEI40Nc
ȨnQQToؤB)uQ,In&Et7jrI5
A>A9PS$Wx˔YB8wq'	+L`ұ D'	XtiѸI:ʢQg]hC)!2&ARxP)z,r()H!Eh=WPBVy_'ӫ#j)rkįaq+б)&(z*/A\Ap/liK{&zL")fHL)hEf ;K?P*"Q6(kPҟ<eHfI&,=,Rn%v(I,XstzRE!'Q!N-th\i}?TOCYVHP)BHҾ|j7i-E>+r)	N(YxG[p7Gn0Pڠv)eh܆q%pm/':ȦEupx9d6WP"aSDcfn[W^u4tf	gn;K6tgDA/*XOG+ǚ`VVNH.cI6^N6Gr\peS4!7x^OHQJ&Q!ҡ6MYO[tYKTtR]FTIVna%B;vg>7} t]6cdBnUA-{n	;a0˓S12.pGD*c~1"hR'Wp7A'UCKX	"Դ1
eG!S]p%8J"q|CY10
H4qf6O%ү*;Ohdq];{7w`؉cJjI%$*B-,:[&>l	eo\Ԝ:ܥQU*wuC,6!ZmŌ\
ht	7<zՄVrFVg/~z#®ytR^	46H9<lB.S| 1Ul@qU1hTME5Y/N@q=b؃&\~h'&6-?[NI˅}^KMPUmw"8|ڄ9Os5p4P,eD?Uf:3P6οږ%?s7ܚXM35	bF47ߧm2LaASY7f|k:PRi*S}TS+LH&h*LH!h̙҂ŎTX虨TU%#eGjrf*9ђ4'rik_3ED˫L+\yW|x^AHQowpw.BԶŒB
A@(afv7[,DKѽ[THDHIH	RA\2|?7KD{7sp:EV95E)<Q{tѴJ}:Z7Rڢ)Jh's6SX1axUI2j,Hɺd)cx+͓xe3ATؿBДlPIMIҤ:AP
S:K{╠@*NfGjm0OJޭ^e4#nMY!R<lޜA6PNRC0N@c (X$~.{!Д0/]6\gifu+̓>(B b˞zUIBګ)٠IHA)h::3ZPFR $Vr@SR7G^wZek$ZLH',ы_Y!s	T2ajn4I:F!*TN ?^\ʾׄ
JIrӯT7$ wwㄡ⺀p(_ЅG<醀~PYvqd?EyuyҢpS0
,	/$_1(UMx'}BkZȦ:I?7x^_HSQu & ]Ii,n5؟@hEoFz!"f
""","{-'p}{\.ahA7l6!]RXaapɸ*LL0r`_ <d
H")iD=RR_,Xy:> Qr)@ܨ%Dݐ'D4jψ)UV}AIE])*HIII#J+H
KI{g*$(YD}"D%F%)F8[E=S5H:GQE=SHI3Հ~)ix.:&YװID%ᝈ?yZ"jH
&DSFp}jԭFcgeks/>Rf.%ʯa*sǦa
69eַwʯ~z*ϰT
iVV\"QǱB"6CH$fDȘ!@KוY;R,$b3H[DV@T8d׿-O/_ͫY!ٹz&v;j!(O$Vp5???ߎf/w)n~lhG!:﭅Yզ6 k[JVs|Ӷ =bՇ[eZWBd,UkGv{%x^͖Leǟt
?0ls4љ_mev]{!?ҰbbLьܦG$Ft2l5f5ax{w.M}?]^?|@t68zq0UaEf5]nU]+z|bJSbˊuj@6TGj*Lq&'

-=rgU,0KsLk\plGsPֿb_Z>;G'tVlUWck `15h/es	=Щ UTiLqhD:eW2GOQ^yB
D/+)
gi#@CM4ˆ0YAge;4xK,bܴR?Zf9}F`N9Awr1}YPvW l~1!iҞRr{ N3qz}4OAWv(x/CB;>P Ff?(Pkji
EFh/DlHQD=#L	UUj|غYlܗx*RfX:#~^GbkƓ9x&-Vu	H̓De,ۣQ#>`<R7"#;6@npR&Wj]+>UFzY"`۷&ס?j@mUPL73vPΠbƥޢ"LR6t<Ho SYD{$tu,gQo|xXOO&3m9Hx(9}g,oooւ1C;٭`1I Yw&f(@劣/uX5KhoqzS >`L3N#*\D.G)pF	(:LHbni[<@U:!2=ѓ)d%ERc
	W3{ISGI#lϓ0/Lcq"6wp-dDikiz:6P`%~c.:>D]<yZ!NllтQ/Kx^lT }܀!q22q|80k+v|h@2	0ȗ&G0l7$H0јG$"0M4{~/j;>ǐx(^p!`82Ag9]>,rՒ i:+ATKܕ͵ےmqeBidQ1$FjٖĠ3gP6&3F1qs療}@j%)|}	kN;b8Afv9[Ӊ]a:V,Nr{c#Hbяn3+>r3yh;cuv\ ̆&\+"L:Ɗ~1ǇW|Z#{D95MnYv2O\ܒEsfI>!1{c@"e~\EˊϽg.xd&_7kh?sCk7y?Ѵ<mYQ'v
θx 􂊒dʇA5%Fe	.$(zd5
~(uAڭuy0ߏS&K@~NA۷7˷7&D&ew"1<pQS]t0ʒF⁓+̒"\HYB	uP#~Iݾ*JPYICKsr?_bɍ<WKk(ꂦ#8_Gڮ;W!H*S+qSvig6擜Rvی)EXˊpmLSVVg4.Ċu}|@omK[mH5*ch~CbbklYٰ[]<+.?Ԃ&X"7T?ِc`nh>߉erp*^k V#m˜VfѪn\c u>fܹ:8xXqNѪΫ\.4tsx-'%ݕlufT0W91"CqZaNI؝.wKq=!q{ZkDC(i7ƍ5Q/_'Ѓ)gqam@͹xy(ǀjd!%%"m&|E0}?)N"Ax"nH{fnr4:/UF֎.7DE^Ze{Xwʤ7}ҍeUQs6R&\rrDTߟ@~r
x<F%oڨ XmĜx^}lefA6u08KIXİ8ht}ݼuwLc٪24=b*1QDB3=O=wKn7>ys}C`W˼{o {cgA5HQ3BTMT.0&/05?9cx AXNO3ͽ47D]Q&dyvtu|Is۵A} qIƳvBt;gQ4؇?_-u¨rNFycx$?tDIB߃Ko(T|n@QUzuEsުkPԢHZ'7'60Ay}??F%Q"p2{Z[j׵#2ԅԥa=hٽGyJ`!dm~i1;d)	eIoXuPG	yNy<j7Q~OΕ惎e_\TC]2$URlY),ݹi>jĹ -RLDNlj.-c?;@Kҗ'Dj.b$_u,?<הzVKFӚ]D!
siSy\TE9Y-qU1ʖY~	ޟM j.0̽?_~\7ۭ9+\-ͅV"݆*X
%ҧ57w/H>n_Ii'i1ҮNs}tCy9QZiGh
,cmCGd7^ϵyP(a¯50Mb%<L\)!%6#RhnlYrYkd+ӧ_zy}iF.q?sDyπ-(c}+nr؅}FUk}Rh>V;*:GJZj2͟πw/$EELέw#x4pX;qYŇ aB)CI;y2onG*:H"j{%a('/shIiI]2LBn<HFd@vL<R0cK؟a@O@eZaI|q~uם{rh>hZ̿4	6.x^Luɣ¨A8q"g*'Z,2=J;*8eQn2C$ˆFFpѥ0.N2a&ǽZj/^០ ;\6;ƠNέc\QȮ<5G=D"ëwn2b+_[d(Ǣ^8P(O@:]Μ;~,XQ5n=4WRtrx~TiYCtYpU}p~"(fq4@PN7Cwaz_
?lYEcf<8&˝G98L$z!;
LO=G;(GhIrF0Zl(`Cs/J[9LcF?ӁG6Yjs$]Ε(fjNg5ݦSxb"؋&Pi w
NI
GO83 ݌S86m4VHb*DdW'њzԁA~@&i˨i=$nv[2QHbYȮU
%h'7Z?]8HB߶(gŸ!U\., (|Q7!\5J9QO֊x|%)!hRL S<pm{j$`<nA:9&`
L'BS=# aQ<(8q\\(|Ly9+D?wY]iX4=JK6SIRbJdN;CW]s+Oݢg!)u9RNF݄ԲIPBln`52{߇1zXak! HiYVT\j~,ɶqq1&UIRh-4[d2w&lه}h}bC$79-+{zPVaQ.}w9ӽ=Y#C~}:OCF:ƥ
pGPc.,3(E8NJȟUr}nӈBݺ(2
E,_;S^C߻V^!93xq~򿋝c*\ɊYYܥ>z+0[z^)Vzsԧ/0tD zjJj/ݟi[OIRc^YUN*!w>r5^;/UX5z%
ٍx^LU lADNS6(<Xap m1Nw27&ˆ$\bQb,Q7tG+3KۘfoDRWJ/ims|޽k$?F:]T=MmipVȆv:	?DTj;6Ox΋?ǱifA%}Y%ޛyf50B[0zq2&=u/Ne4:6J\k "+)ƉG?I%vt߿"l$|ӂp;=Q4Yxɂk4/vg8-^jDm3|XYaI?"2
iwr$%Rf/ÏMDghwc		Zzv&ZԷd$%BsO'Uғ	.QL/熍T!b	>ԹvyE%~rQ;1/b%_TVː.E;WOۯ?5)$
j0uh5NM<z#>Ʀ>ʎ_U6_<q'<ܳCNcAu4_jVAϳO`&I	=2ͅcK^OVwE!g'&Vn$"Hm<93axʀbYH(GG)d)#(H2BU{ΩF4yEVQzbd=R,/̧6}j$ez5=ߪ]Obɀ*)DP+6?h?Z^HTg3sR(Y1U(VO8:y|V^cʾ*ԞA+PՌ@B(([X'mf`MݑM'&B_tYXn.3O_6?>޼bQE^g?;d?ݮ<4EoH&ldC}푃au=d_H<jOF3#-XE7
H沋	Q#kJG[VuOiFBE0aEUnyL}b>mg7>O=@]5JAL*w4>I&3sdwWks}4סx^}LevR`l0dl&(xZ(a	
EB
,.u4s,Fg6KL]20*L\tpZ[&<xPFX8(Hã/cyc_dE:!]SsVA1=o4i!ZN2p>/א+2
૏17ax"Zd7>~}OK.}WN8uX.SLï|)EN[X=F*U{a.IJUH&dcVRKjR%	4e`m55EfcֲJ3-mzw׈$vط\ڼNk4Ze|FGԙ7,K~ΟPrh4Y+d[/ggQTsqܶ9wG9:ݥ)b4mlؐY$LC5h**sx]6V}tFx+Hg_N)WSO(G7¡Uܝ5EKV%S9>۳buqސv˝H¹ʹZh	Ċ!}zCVa*Ih9.IHQA#=\8oe\NMNQT#2
6!m'BA8q7z?M`ys.y{;|FĝАbZR ^Y})$qv/uaᴺ>$!c
K"3>YyxM8t&	YXo]cOR1$6P
mʤhMY#I_F30Z:~vFTcmj$+#ykk*	29D^8yuޢ-*:U2gt
NO㒐qd@׶u-3Ll|?,Up,T~HBo*LPͺ߇R~mֿ0$~_܈(\.	<W΁]MY*	J'[ĈVX9Oah'<FJy.	!=-"^ pv*
ggˤsW.C7T}hP}&ǫ0)P>Ғ%@x^]lUh]wVZ1hj@4nGڥ$0{w{O&(TA[<AS$Gx0AӸK"J$wޝƹp?wrw{ΙY KGxŐ邥坟vWSaG˒산,k&hQAq@\mN9~<NtUgUgtf>tSMzr?䅢l;;qܾ-oXvT85Al#bOD/Uhm{!(%Q(9	XD*mJ@F7S	ͭOʓWxePaHژ"'XU=C7gVϖ}uqIzԃBS̏sܦ fޓĲ_+=j(A5nuL_TjXl23jivw|+UG+o2uu*!@1}.ҏ*ʂ%rjoߒ`,ThR\C,`'hiK;֗
Xȷ6"e{ډ6,PD䄊=zQowPѣ?פQt{n㵺~nՀI*ŵI]}PSb-C&"6U7!{zسw2W5@(JRm|߲ɇΞU.H+(UM=%z} 9X(տ
_Xi5$oGusNMp~4*ɢ,@p<ި? ZJI>k羘}ï~w<xr]P,}1}{l~\:y+XBc3GVOUd;APUjA>b㋄HXȤ30l*.e;cI4sgougt}g?3K.̨+:q&!x~\UkRiw]E
ڧ2%xYđLŰuk7Wp]gpQMbIb#4VV?MZ8s?ڭ 9x^]lQϪҖ.KV6"dY_2Զ;3ۙjDU+>"H⁈<xUJG5M$Mqg1$frw=sO@\<suLiMF$#&hI! ԺhGNw*,/I?/H:mfeXq};Ƕv|GFmg;)03(UZtm3Ayē_ 5Fb4t-DpS!37u|ԁwN ƓWHlb<n;B9\T6vh~RTcާך ꅚh2m697MUXT 	Iugi^Ba1,lp֞bfyP1'H(ܽ8\L'Qb6	S_&?u2
kXb4Q1BɤDN{45*zS7SX7<jYBa C1WgW:WD0!S	:.~ -`CSV۫2
dY)Dv7Crf۩PqQeMO5h%#e>66U?EUh3BHm
EϷZP8D2ڲ$/dpC-3S(À`6nXO>XT8!@1Lt{%ڎFytf&T˜@&G[O(|3`_bܓ-7no"ڏAG~'.uOK %jnOZ帹h4}i?jxr<s<Gr4}Fky]@mS0L<=^5#p{~әjqvCig)[au;P&vZفߴ;΂&+̃x^YhAǿPm*`Պ(PjhmEM2I6qwkx (x!QTćV(x>VGAhuv4~}p!d? ~L
7dvyȑUHsfAE0Z,"WV3H
kHd'ԞhN
1[6ӂK}7&L3CX(*]EeISd'HD@ͷl*#lXx7֡Zޘl*@3O81<$W(?@jPUShFdeٺ|ʕ7B]<z!VL@z/YݰsEfh~S-J'9'9RUwٷqQ'sGa>Sr'5@ʕ$f(RjT[ٟ.'$fϪbGo_q7
UHpJ~NVX	ԤeCWoa1lQ!"ɪFiz10pJRKp+Y'?hҕCQ)qg?߬<E+!a*Q}%m6\adOVB6^1?p꓄1,(}275mK
''t""mDԤI_.aY *:^[iG\*܁penv[$VnQWA|:	F?Hs[@\PF!(Z%Z><=CA"R9f[xw:AՎAgE4>Qd&1qT@= VI"ۚg"m
1,ǈ W:)]8*OFXʱ2\7yGov=Gg<PthݼB1m7Z1ޅs[Y5x^{lEǕ[B4-^Ah5퉴bcJGYJA{Co`mj %Ĕ+AE$Qb"j0`L\y$J[M4EbELqf۹Nnf6~v7٫Wpx<]}>)RCSU++qUDcv#
eNӠaS4iңX2طZH5яF]kE]e,xSdu;cJ޻͌8P9Zc1ѡOP(sb	twj(Hfd5xdވ1PP"Pӣ}ת(:1Mf:cƤdy/yķ{hc#'uA=&SĚNfOW̨Y.}V컦B4qԉ``ꆳr[6
V(_V]'[,wv2bRSYWPaht0lXH8|)|^@zf}|3/mo >d/x%˲+pŉm4kY;R4kv*/GL?ې{:Lt
ߢڰm&!ᖜbթACNjVlR!-ؚ8VosLX$w$Ѭ鑵ÌІ=$,htGם?I4MĦSZ\C!Cc].XOE%C$#fdUfGVmf
Y]ۀ+!iHv&+΀T3[ΆcgP?0	1Zەِ^aWH8'c5ƨz]C|] )xύ׎2' Y$#UBS;sN2>xFM1Z6x&/YwTRJʪ,E%Ikem-_a$NrACsbKNl^sm{D,Fc͡«<#!9#	i2H#s):fI^~-dX3S/x2̷Y ׽"xw'(2ȹ@r(eGta켍)a/Osg
!`+_t+IH.;0L{<j+)I3$bi!,4aTGy<){j&
~KGA'OPc^0*J*-fOʌg}.0םLF7l+wIjYkeJ)zx^ylUSJ}Iicfw[
hKKݑffRD-?()%1((""tbCl}3owh$o~͛Gu.Rk&Ak(9dH&k7u|	(ZP-&$ uZx($]M-"b^^ԯWxR#"U"b OpQbN$qcV 
m
uf&JK_V0iAgA׊A9k(LIMXCoWQ/8?wzP(B	1dLN W/jA%
7I,dluW9/S-Tpg͇miu˳![QRC>|/bqʀZ$r,&ΉThi~nH됦`r+'rsكTUv8To@DCzs$06ҟ?\U(BOf^B{C͘_A@"W6H&S(k7BNEE`ա	:\t"m8=юZ)vJzxed>sn9e;MԐu.wP`Q:Ժb*QѢkcHԶjE7-Y?/9K3(f9꽕!
b7PU)krKDazi$Y&Kσ:N@6gG䢡|(;01Kmx!5ںCd(|v*}->鸝jk#Ϋ]WRӅ*t:nU6fX&HY>OIvPvN6')
*A`)_P+6?H8VTDg0YM:%ww/~M.X۴=K@Cr	zh:s6 ,3@jĐ l(lh5aX3Mә̹Hw(޿BH@D|&\ӻutTOp[x'5й>tOON6C.;-r.72KCg=ԃq7z(R]'ce곲ʶ,kK|e#c1[e9ºm{<Iv_[c2yߗ"^X{K\1x(RÎy?:Bf}llC==m]Pcf^IjXչ&t}W3lĐ!2saeA7j"O2eXr
Xv4f"وNZgʬn0,|0bHʾ=͉\_?׭x^}hdޮ/ڹMU;Л^m]h'ԍ!KrL9[Z;s 1c8ѿt-]d;pcu8|\$|>=O 'ǂgE	uMqv0AUh s`U$Z|q'ښ0<J(> ]+	s^D҇NBٿ&\BAFe)^enXkMhQUARu'r&B:+KB\AJmGZ8oܑy^(*^G~d	^eGXЄ5axHNhfˬ5ZtAlտ=)A7a	OyAO9oa	@0,Ɔ~ n:N3fk;gϹT5=ca*:0w	L*z"-sDLjZbHհi~鿰$c&5M{ʷ2 KUPstȎ-vsl]QбE}Tӻp޽w~mfR2Zv@1ZFv%M E94`e&e5ެF9"ِ5axMJ#3m{+dM@%Aux%0{w#OtOGK.sx|:dIDd.y tm{I%.%Xu6B8RKH&ZN5CⲔHRRE.yo$_;c@BP5~MPsdL[mVمWv2SI"2|vQ{ǲ7]؜WU ' SsDe$U쪲j
TJewʑXf$<ݝɊvzؐǤ0#[[^Usu"cz+c$,5m.jPѳ_wMa{EkoJm"(  Hrkd|!E'6.BSGIs%scp4cO:ٵ%Uk&g|\s%M^?n DGf[9vz@7&JvGVsb,mąx^LWtͬ:72aS( [lS<˵XZ^Hm%3q[66(mQ0d3s{Վ%/~ݕϥӚS7;ѱݑqy#ĶfR_ɅI1JIOOFUTkN'=dٌ0dO@@]OsL.9vgvEH#Ǣbc<>=yp19x+]oہzn]4h(͇}鳨UmUrIcc`,ȡMVXv6qm+v"D0CmZC[Y[@=CxR1*QMv^Wwޫ~+)vn--j$5T˘ij	uSIWAt[-}!zp<xג#q:_*#`uW>1otiMWthm6Lv@=
6DJ TԃN3Q).$0cesY.tT3ua[ËDɒ/77T8!}Վ[|.Cڢa)V؛nw"i4(!$TUImZOG5@po}Y$,-26odKruT^at*6E<A=nNv"9t~99P[fb b9y.p)Ȃ[G(`IqyBqbgDp"1zDE%9zA.J64Ϸhi Uo|He4Ky4$6a|g.;kwF$4-Vuu"PݫNDr's4'zZ 罦mxTsM<x&e($4פ["=wbWL$^<Q<ijVG	0$U0rTcAkbR:JƐLYDWEOw2OEf0ے0x72g#l.-jh
|3ww CVᔞj8ul5^]ZL8}
^!CςWmWˑ(DM1:֐%ITohBA6IٜCw	++'_SӎH2G^1V)J}gO \˷Rw#7iwnُFtŁM,MqDUpэR5#CtTsgr6_+NTC?U1DZ'"9L Lt#QSg"}ZrWaV	ۨǬı<%1!AZ'2
&v CUbYPU8q}^G1VwBemTDf4uĢESH=(:ЁD<>mx^klUϔbҢIb'3nX(T)}vtveK%*jM(ĨK%Zh$є]#bDbHhH-Rę۽Yus3s^ Cs^y'Jkmڧl1EPjGtTyy&Oߥ<|fEeATҾcߗ+JaHH'+BpDUʄ|#R>x
#IBʆITEQ7qHZ9wgM,@;]h6>>w5+'iR؆KSD@t
3Y!ˉ01z$;'`.J5V%+t
C[rm]`r31?Lk6y}0\u63?E)l1-P^Nv6(NPzW/lbUʭP!|䤠,gvp=}؆6^g"1霡qzv#]YlÊ<"s-EK>ߋ}yq¨;ldDs/YecPLNE˵0*qlCVP[B]ˣhL'NQ؆"),yFdɈ
p(]x۰HɱYl㗥̹pT OVaIREI5RjGDv
)=eBMo4c}~Ȯ_Yi;d&!i;dCv	5Jh*]_!JSw cJ[w"#J_w!QVk*HHz.Cߓ;C#=:Cʛ@MڴMMfnmZC{N"XKZxhAo=91Boyi`=<*\XL_#|eսOuO"_(Ms~K4qCyCcҿ#?Gkאwwvno}8[&\oflsBH+*7krDˡV&Ȓʵ>MYv2,K3>k
'xu5#⦦HsϽŨ/2pR@:9Pt[n骰	!HOiϽڅ#I.՚JEA/E9t\,0Km?EN
 U_D	Mx^[hU3AH>XhesC$kڒ&ٶ:.6BT(6xZٶ ԦT[XER1Uf+(A覧Ifwf/;">%v<w5`gnC-jRJ"d#44	)!))(ghrFҳ3	@$ttoh7*~fp|swM~$v|i0Z$n=x;Z2R0HP*R2n}VzO0pqfLّSЖTyH3"Ka0jN!bl_D<At՘w,f%91t_\`?}l}*`ڏCF*mU
 iyzxVr+^b$F0麜^aR$I]SǑG#&жt|y9 z»cRB~nLbr@Y?}A#XouX)&責w흙wKf^Y3P\֥JVx!H>xݣ>Xx+#<ƢH8A%21%́WL"R\ZwX	"gu& d˖zp~5D}p8g#t	⑀-1$`C\fQ,C9T͖&A<1wʆR
˹myu˟8}J\_7<'ai:!h+jnOӨ5	ѩ=	UMp=+4mi.U5C.tֈbLoIOnﮐ?WUVOUlK
r.<)B]<wLThO0.`t[[~Iܱj߇YH3R+c)W؇plau1,Yb%}>cxwm&DOp~_~Ԫy-'<ueUEA1úl;EU4oCĝ;+&χɯ+q5s<3~\%RUV~&}gxoCNpx^oheǟk\7SH}!Юk4l&$]4-C훁3QWHJ\Dle7uswg=&Mg߻{s}~gVM6DHECRҕmʚd%5ՆVD֔z$%!jAgK;**z"ܗ"Ӱ>z(E7R(9pUAقlVXw0mKAR"Sd&뱔S7"9sص}|#\;SsP$!<pAS5)"9TA#zَ+q-n~סު_Ϲ)X$V4QH$Rm-9t<ÉGr"*V}bІqK=_xyTACJW,K9hC'(RL_<%ڟ;_08:Wp۫;#\rNx@y$X&r|%s&Kz8y4]kXcWa@#5:j90$'47ŽD'n[N@\@iBxu3ȵ23U[%'
MLO(;-,زő;rF.
vO6WN҂:À:
J鶚P }sAG b
28@Mu%`ʊ;,/0`R7YYTA(cmaD[hyREl(힮LEL`
JF(Jzqsse'G1(6Y46LoFcC$ݍ΍=Ws?`siߜR382-44qۅ,1?>*@kKp[ܰm 41GVRMgz`e#?H
ֲO
qX`?<GC.Ev{ǫtĢ@v[F |rʿBpN2"l2SkVkI}3:WUCgY1-G+-2M؉*6̮(TSg`]D@ao+ |ick<`2ߑZx^}heǟ6D/cJ+ND,}\.N5II״ڲZ]Oے6w1iJQaS)PAW|a]!:ȒN[B&Kߞ-yZ>|/_zL@E
9Y@1;VE͵B\[G`Q6|<夂m,L{G(ѵix,2֟iw%@~+5+V,ng!/]\69_M1?ޡ	
wXXe!@
97,+(VcXaTR`g{K2G޽<A*8FCLm@ZֶM
hW7jPT!'@ѝM.4<d<5Y"v$X<,A7严DVr\ƚ1pNo: 
- @u}/0F8l+QCL7r.VrՎOy=kRAs;uT@7TCCyVC9uX6<XŭPC5?C3r
bJ7̸S#(*.(PXvV~Ł˻Ә5 JFF5[Ifc6f<RCqcxc='C.vIGoO2{ݸkN'2+l4P9 3
n ,P||k4,PdeLkd-S-o	>bzo <P  ]L"ZD45es=B*)^j"%i>vqTC(.ANz\ד̹Cn!Ȼ$.ÄƷ;][wG'?AA%HNXjiS<喅[gN:d)RLSo^kA߾,_0G-xf){sJHR vϧ-=~wTCbJBգg?PpW`MŔIR(DRC&feɶ"ˌE5dehC[F=j
.°Xӓ&cȴOԉ{[йɻ6B*xߎ|f̨+G0y.SkՉ_CokTDO.~e=soyRA$ppx^]lUϤB	"j=3?SS?`鶅%Aa:;=[&;YgfٖDITb%	6CHj;hET	JM F=3uۣiw0;ً9O|{.DM=nvEf>]"b!
!ȱ,ydE,CRE3*T%;%uJlB'b|qn?ǒkJ/\W	<W^ST'b:]Ul)&qPO%c63hVIՔ%W""7\R4شI?iKN"Y~u#ErC.PRei,3TVpR#TLʺj醋gWgC(: sWP./l~K~0 	0 =p&rqW9~p^hQBM}~8NSpbKa=^FU[yۏUO]2#7߽ޞStA=EoN)j&TSqSYfmmL+8*LQkVb&DRVDR.8~\d]dRpp
dLK2,%:ŹJl3[>l鈔4 D!V'kwft]Uk|5{BӨugܹ>#Dݬ/)oS ç1o,_s0`_aW͆+?\rᝎ3>6Gڑ,/Zd&eK]wh
*\o_>u@r
 zb/v'>wΞS#{
0Hf!ϑi8:=3H)8#ش؎AׇסዴtL㊌a[tpș"Ftc׋q;l|hV;N!7Vl8P|y'G{K}ICECӊis/ߢ\CYuivks$๢FW5b3ÙtG#)S0s<O2dl,|fN3ov
6w$&lp_8<62~9A+hVl%u#x^ohe,'EKRm).'-],p7BEJ
JZ:D76=^{M><{ `?>pkbޚJ#t*%|"=idRU0pT7G,H!/,Ἑ3Rӽq.x|`״CdnSajVT,LC
@?,fTXʹ^oÏ[¦sd>pTїwmW;hTjҽYd6+bPr
oÆ>;SAjO\	/ڥj	`K_" Y$z鮾.&,f/}Oj'\oߑK)xD!g&;|;n%t\5{ZJ⠳N]fCdŠ/	f=r$|ەϑ	HJA}Gvx뜝c[>ٻ+TjS5YS𪴲
:{W$LRP(
vUS$lnPD<uns;xFR;ogMc|jZF&Le\aq\*zOO^STu͐Y30DOSzgUL0PLsSa} #=;l1kn%NPµw}S#h4+u匒ȶq %y)sF'<Dz"熈8(v	1LmLꬮ4:-d34֕Kօ=pêa: oO\A?\i'͏%>Dj CoT\&ad<q24gibl[\'@>M [6}sޡS;tmU>:ƥr?F)ZU#\_q'k)yC?w֘qZdL
	W]Rlsw4Α	 KtG37k^S\ W"dx^KQVڅB4ggw2%]#KavMlsi"nO]衋ыV/҅"H(cPD=D͙:6y.~|o( fH\#]rs'IMմG5r2WrQȉ
6Mʊz.+0+)-Ԃ[yiM)!cws>[YۧFA+ԓRGkO}wMamq5a\2CjWD<eGâ|c=BN,Iz~o0Phe,*w.S1iF5+?Æk&T`B<̅F	X@W@Q.Q8R?l#DDgղ<yoۮ3lM9\ޒˉ0
U--<慶Hn Q-,Zqhh{,,?0P滛&CNSK_6??*Y,~qSEc;pM;QLPآxEǨr
j" D@
TɵȆtt{&ip@e%ZS	)n&^Ba畕~ӢW&( Yy,*f1/E;h)hA<Xu,gkI9]:Y%S+k	n.	6|\zwI=i#m&OyÝe9;߶Ք)S:k:wL;, q^S1S"UNu<b}<k=)d:4G:/0DxV|fVI4ɡbawڥ5)R98b	&'x:x^[lU(1&5^i\vfgL)X4]JlUd:{vg@DR`}#4Ɗ`lv45*ZIzZ,=vOvOv_ gfΡ7@&h`r)֊`URB2~ ˱i9#dYLF.,66/l*l*YyμHH6fSS122CC&HsPDL*1Tд`}%/Hx[r#7k,lpsbI)TL7QK!%>6hu(٪Ȅu7+&#r<.
,XXPȦn,#vxgڔ_:Uefg9ȱhVin7dÿ~Μ'| ]0>p܂?5Y[FG? !o 8%^ҴcBH>-|^]K3cN֓㤂oϦ<BPbd?~($bGb5,'f20ꡃlC>P͏K(dyaW6uV`Ӯ>qni<:铃Ԏ~bSl|HH5a4]PEuWަ>JT | m$^L&ej39=Wmav`5<yy۹9ʂ{lM;C.Of𐗂]MbKwEx5pGlJ_T0LqCqXf_4-J<r%eT~XY~!n~0aqz_47gmH"\\T;㫑pf4e?'7/]'wª咲T}5ZC*h{\%>n]wU64iԱ.a$-s~N\˾	RX>L){5bsCIZĤs<ܦT$Q*ܢ$oQnWQKiRA*+n7CcW'}M
z@wr(tK#?e%vr
SQVZqOuNK#(~;cȬ~j@&PFU|M隊T(H^f#gT3GZx^[U3AȪ/L5
{amXFg;vh;S:v  *1D\0F#>,d>H lcLsJߴIo38ZC9|t}	04 34r쬒<Cf%'5v[_uhL/n]ӚmF\N<YDtFJ07%/ H"iأj'*WE@cΨr2%oX*e鯸G?Sց~=5-3f!fVE4A2V&Њ*)m%UZ8©HAO%ejuשq2AqH
*Z:gQMR2Kf(,r/TZYK'?gj"lT< Eb1=A1IG:ٿ-L]l|kI$lUҢ73{H
Y5ؗUZ&!	\`9ֱ9}_}GJ/'_	οAڐjL2Ͳ9,z!HE&Xrwz>/d}SDz $z4Y6 T,p5"tußxu0bUMB_}^|M9

xUp~xvl&$)<3.,;MwP5-%5kłCZԷݡ	3S &m|[Bí%5R'x!=;p(nM^HAYXa!=-|c
 TڼwrW0Myupv'EfD#< 8WX<E$秖`1mHp&zpl~35x(	rUI9Ӛi&x|qJP
WI&XD,fL8@?~itHb'hU˖}MuLk^LkI~e	Ū >/E}nr50w+{x^[hU3E
4H=3Yc5lLvSJQٳi3Lw#Xw`j>HKJ-Z;h,*HռXgl=6;ɜ}_e|;9(r	N0Xxn NM0w6z{9M@(Mpn=mA$e$@rbUrL	jQH٪du`I`I+I,v좚WB^a^5rlun͌l<[>hijG^ECxé?jlCԼa/ڠ4#1!2k[V5RX:[jRDby~&:|> B4!t̀f	kZJ{]MEж9N:)<Abde:E[Q&Eٻ'}T5
\gqb{6K	HS+CSiihlfuþ:p,$K,DG[6eJ\fݙ'(@rI,5Y/fg^!@FBr[Rݾ4r≐CRk~˰9"gtD Y=92K#6,omXӇm\M^fpd	rlpq(Hb|{wظe&y	):[GaJ]:A]w27v`mȪ
sd+碃z}cdzfZ!ֻ\=%_A2AVٺ682maG}|zLPk׍\y{{m[{E]ݎ1g/ef#hZ^%[=%7pL0JD`6ck6mBaj>w\y[&q-"L)DKt24ПjN=2~& vG[7El#W?9qULpҵx,w߁f0Gd2Aq }x^heߛlJE(BiѡJu}߹0햭ۨimu%yIKVN!2:vTPpV*s3Z;4]}{ ,nuQΟNYpO\Ce<iYCqP"L=n	͠AU@R\H
(@C}όQ-ң?2\jMG	S!/GpjǕvTlTU~9B<J]=૿]Py	ͺvVWHf #<1_Rl(_p1*"S.P(ͪ/QSfhx0C3KK5>:k6^+M{[s&c	F!0^/+BF$~lll#<m9ҥiP>.::i.I
Y
l!.
VuĦJH~v&-TCYKpwK5{2:4a?':%$ N
xN0Ѻr||A:ݻzɬg4-ГlW>^gTc\ NSkRu :ϐӥ55XJ@3ǳC4Ud6+}_ؔya${`E5f H9CLMmyT=Sy]2xk<eP8@u32J%?]GnB5j`kE"΢5|4`m:P3zht6oZ@_Q3ұ̆*W7| 倥<3`2ÖPe4dcB+WMOO
UyfU7ތ`˯[ĉZ{~/I
Z+]ΦpW9glmҾd'uJ/QEk_.*b]PmrC]Yf33vôV]Pja(zsðal[|PuowH?˿e5ԉ`c\(8솔ĬX1F=G"ܟtܮ/t7R]5-,:i/]o9K+0
f&̹{Bfϗr[%v0#|Rӹσd5頤9?ӽx^mhUmhK*bTJU
vVb&,@Eݛdٙ83ݨHTVE%ZV[6|!X"
QK~&$.c3{ÆnU7fS@cyr4YfU*k1$qSk= bTB+=?,aAcWr|Pd>(x(<l@z<)f>~0)H!(Z#XVb-RX6M, {'2M_
rAX4i8yf3D:sfc*/=1Z=.e-Ԭ)<AWb1{fyz
ڧsbYb!E-2òw ͆40~lp'e~V5s$2\lիJBBA	R+HR4CO6j).omc\Əh{.Q)	RZ0iAA"	\@YΦ?O1[kۺ] KkDB 	ŭmKS}Wnɕo߉N\pnĜbR]UqRt %#jK"Yڞnہ+鱷GtKcFdm_˝_.7(F16OC[f-/=N/L+88?;mPկ5i(G@?A2
T7@&ŪlD9cBqu{6niϛ̌[	&\|pxY.r29"YvE^R:o+3`upEYkB(*Lta#yzuQ@5X`,N	A7In{yh<qCSω@;txr'n?PewQFA^9ܞMgΓ4SgHkoZ!Dˢtrm_QfRpqgsq=$Y3qsjGf#G1M	ÔѾ!	~vvb
:o&`46У@+*"$B6Ck ^;h6?pVP헎x܈x^klTǯhT!mBHy8vc&TMhH3NrqNdjC|\U!X%@bt$Cj[6>tZ]@	a_V&U<VؤqmU؂+Y'1RTSu5S_n]`i]YBZPP&'YGdXXU:7|QEE(x%xE֝e2@=aR/{5eU-		b%Bj>;$5px&@*8dK qI!M`\1xß;AX%|+Q6J,ߠeΐ!>G^%ߝ[81v
GlP4vRl&SzTQ-CB@9@-P1ۇ3FHwe*CjFY.s+eQIdEzޘI|Ġn>'웵AH4<3Xdx7r}|cqoTXO#P#`vKFqU[X dӛ}]J$UJLmPHtO5]7x4$aDLU{1UPp-h.SUUNnYƧr76b=z`TAAs:2
jbH]u٠4-M럩dPA&#h(\ki;ɇNۗF
^"qo+)EE04ʀq=6ovЊ7Sm_O+bgʱ?
~Bk, vvJBg8:z3>C*wxM
#ܕ_ߴஞcTPikDz2h|FӢ,`p9oMO')Qa]Aj| SU<Voŵ"|&OIJlZG{`LG[vw;!ojK̻~0b{ kZa2\?k[WvXμu l׀X/]n+ҎPؖډoG;u d`'NJ
ň(!Wg1sฝQi<F8d,)X~pGd ^ĭx^mlEBmE%l[KH+=H<c<bXskv^%(!ZJ-X&"1b,i5%1cv{p˛33sO]I]p{ڰbWfQHr)
'
o}E3[S4DȨ<BvǾ(ۅ$.[R=/Ļ3Obg|/Iaݺ<hƷյf#>ɉ&-q:D27&Qj
X %+0{r(ZZuɎE%NANUyX+ĳeF̂4@,&2Y'z!lE0Ls]"s*3	>KA|r֏@ݦk}?ݹ0v}Ļ{z~)/Q	Z832GSqA:	)}l`Ձ'O}_Sk+%aQ"7
F83M3g<-iPE4; $+9dP6xr#uJI[Lܻ]tW 1(t
F9YQD(69q^.v=փmvp	㖣yinc4q]U>?++Az=?+YGbC&]z#K/)xp,hӵaS9٢Z7HڝyM hYAjBQ+s$fqUBq7' (*ҷvKCAء߲a>MݟO{i,Fz@{LN ?5''}GQ
* *FA>Ql	46jXiSS@jj
3n*؈Vb@A6C_I;U`/&cN4MuLfI3ƃ7`
PɈ]ʬ *\L>K"xjĨ1U4ΣW/[߇me$N W6863ǉI6ib4Ŗ߿̂2?d@qțkP"1>{Y.'Gl-]F[*AtxGr֮NӒLTgcwL>'>GZN
hANB/)`y8,ox|_xx^lEǿm}\-X R@BM,k<ZQj*g[zvvM.5&@*`BAM-VL5@!B@`$:e:l{w@vnQ< xYӥ^D*|5|0iYi''O28؅,+JM/i*#%ȫ!	RG\QXe[nHH*gT1u x)Dd4+uu2
J79[3b]xRVeT0BU_0Px$N>,JҊXv_es)aF1FuHD!ɯyl:Uc	M:#}l||@UɺLtoޯh>[itܽ BHhz^+AkLe:-63Sr'𞐢Y6cܾ
I?Z8=Vұ+'qDɻ%OڇRa^(+3q
x&ٺn/f2Iُ]$5]]dvX̙ab(&htZ;/N<7k14lܚw`G`p=8&+~VTՔsk*+*IU}x.#?z>=mɰRU^Z!uwqu`\%]4)#FrJe,P^KrovS]LNe!%qF`S:F@qcRpRA 
j <ҴG{o/g围o߽E#hZ-4&	muTG̨܃sǰR&E1
_bq߈9`k|s?k?}:+lng-vz̹I73k<H  ,c[_tE^a&9ٳxoIm`h'1a4c=ѺpξfG-eb%Bˊٹ{{]ڃ%7sX0>
k':e 2V|5ױ R,h?Q|/hN~p=]P陝7.&i	s^m!@gmAIPCjؿdTTX8f5*CA@EYhNE\).l#RiӺA#lΩw6{?G{~#Ă$mU.M6ȶ9y(TR]2 i9Bэ4he.\ױ)rʦPummIIHgz6lh~z}z۴H_x^oHaצ-Z*HtF,QV/қ.oyw:_dћAEDEXQHb?hj=vEǗ}>|K_}?T>Hx۴j#ă(ܼUaҾvxϵ@B;4
63b;RI o0F(.SHzHC5}=U5B&Tg8X(8f6vkZ$C!QfiU
*\VCJI9[7L88^F("zj4h]iKfnčMźKIb:WfiM`k ]4yvRakMa3hé?2\怛&=Ֆ*]3O<G^6Cb4!Yj<ά5yh$lp<IkV:Kk&>S-!htӣ=éG/Hl/)Y(DM0Zιߢ<
1}-)zL	J4h&^@x+Uǅ=my9!8jY`7poS;AML)>lAla~t\:	tD?c7\C:Jg##WlZ[-P&%^G::N:CC7{Vo W%~	CM[&ODa3d#ah6KsN$ÄN<Aj,z s懢ϟ|5(|XKmFWjLȪ;?{b!UZ8]j.6q<嶻jN\)lLR7>CC
Y'{ZUX(`XFMp3 =	S?%d8JX鼩[FpeaE{T:qmPK*,
B+>:7/p:]*Ƨxyլ`1>
ĆgGx^}hgߥ$fulT1۴X 4WSl\
j95&ҡ\qZ]7˖?,/-E0 ڢ=_e`dlӽ0%\ypyｐשǣL#fA?N 7X@&),Mj|ʅSN<]υ3HN.#\	5BuTE@+֔?ɣ')obuk袌$??IT.A	-P$k*h&Xń@(9b:~1;vЍBthN?|Y[YdPG$ѩ`RϯY#, Ϥ+³0M*GLXDoU^GAL7?vTGSM(I7+pv*Wط=o.Ldch[&LGߓ 5Y!3ҁ}"uU詤ȨpkWbi\m8ZLB`%ud=[L{NQP%yMUid]yDZQ||1&dT^c8Tӻ}ca]Js	]?EO*yƝ	||sk4fEB':J[ȿؘ|-GajWpvyF[`ݷ8ٔ{a'J#KݭccBO|_#+kx`:)Zga*)L)Kd+1)L-d4"-ơyG y=´̧ϟ1& hdсڶnW(I@JqXV
>$^+i&còyAXg:)	oDdp+@NmPɌ{*a1sϵ+GɨdFMcfYJ?:8aiJc}w5rDI)NO+͚lümx^{lSU 𯂰]7vX0ݺGM[qqckq̸?fȌ"%&\3XSE:\s/nvMN= ӏ)thP6W= 6	VCW5ߟWbKK,oMfs2Z$|󗰘:b`$c)X&YR6$SEjS.TIteh\tkԘBL~=&Fjc-9	Ǒ:בSҔ`rtCf.%:]l^,jWG)$%%M23eĔ\kWmtKO0K6F$QPνh4Nqjcıs4DZ8 3)muԱȣ
W<HYs&HNܯ;Ԝ?Ί	4;Arg!Ld?SH]E;T>)[G2T<i!	fA~@]Cg48UBN6N[	 C1$6ԥ)y}D8{Y2U9sxS2itVK'z	 P}OJ!j.Wu鑤[sY"\Z3xmDn!1vlTͬ!O2N\FiXUiBqY	ʀH<&1	^fG	zy,8VIړV<[$r7H'bi/ID"bm:hCml|hL,R}D\	&դWW
qkxz9:$JXZ%ZN,_$Ip{l#fBkLvΓ.!Zɐ4j"w&97yvxRT"!9XzİM+IjuiZ&2Sm@-eM  Uogtr(`T#K_&I"ɘ,IIǔTXZ<p[s'pWgeF>%}wgze3{~A\9|8.SCXzFP	.=\Vx^oLe ޠݨ~ VIP`(^-EI1tQ7d[bd33nYb],eAs'(]Gk<y)9[]$\yU[72E";
"R|gL!Ee;ߓ=Տw+iҢP\ Xt iO(ߗ6i1y_}6:)ąR,ґ(,"
j;Ѥ4e˗īRS^>Q|(6SKSmTxldŒ{||A Ĕe	<Bֳ[z7y0t}.=HH~Fz}ku4BGwi D
2i+xAP	{=jzʓ<	 XBut/7(ԑ8kh$,	|DĎ9cpnIwvAŗ
t%L.9کxTքhBw7\
bPi3h&(Ot$ԼPctş!-)h hW9ҩ+Tih'g5JO|{`-[چ)*5^
k/CYQ~#_QחP4t֬lI݀ID3+L.&j<]w#@ݦ+"Y~Q)ݮX]4 8!2Ft*፧ə*zlUAU!֟I8=G0(`}L>wH._%Ji<}#i	Tܳ/Fm*17!]Pq5m[@*aߡH59n&r­i50NcǵZx؅ORi $RO|TC{bQF}7a^̏ElOypݪ3"ם{ܔ)đ{q0aJa.^[+N7ENRAjB]4tбUNSRksLڍz+?;9x^hSWj1PɨpڴZ,ij,	&&qslnU׹_2Ԋt"t,VE$Nҩ`jq91Vp1wO#7#}ܓ'F;ZƞPю"\rkjnb|=E|'_84b͗}_''otʟɕ$+GKj|3](N?e+RYjm{*&#i=aatJ:*!	6xsP3YIFIK<@Sp,q WҘ[qz)P\(1~\ɱ9CKELw˅Ԧ3_'t.$nu =yQ_w4F^+!ňZ2vQj"-^AJK9F!C~8V|[ґbKYie3\,,1	`}CX-\I	jߊR-^_6QjUoW1U/F(,@TCui&qir9dLyL(ތ+>Iwh2`Ʈ䤣p6,KP'q1όJ>"&xO(6z/s['\_(rkbxџ%^Z:>"R%\pVSx!FukSh.f|]0 R\5I7kXPL j|Q_u&	Q*ˎZ
0ƒ w7~s"~%ST
7` 6^$K;*1T0QBhA0HuV.gḴ6MwU-mwaX;71|JsztLɠ X9ȹ-;oRHc{]}'(M"M ʸO͟s^gpGcBB1T:iv'IrE"ON르s>:DZLGdĝ
(tΝ	<2` N|c 6ʘhN5[J01358ic~+c4U-(K?Wdvx^qlUߵQ)ceC(5:F]iV6ٖzۮ-bQ2	bL3!01
s&htl2aJFщ18[_s%osｻ  l1a
dgaPB[*qQ:6o3|NWJ	dP>lgAPݜldm#h\3zmhh*#?ȅj\5nA	Ps/B+H#8:r;=5v7&L/)JG{E(EbF&	(׌x+0cO4q+cˇ<)?bx#1	73
X5;-frdւaiHΌ6$;OWW
73`՟T<C\PE$xWϧ++VrM~l7\xOWro 	"H3͚@64os~cGԑG
5+%lNRtBrטlk\ᖒ[q)0pq<HsS*9ΞVU1&K*j\ᶒe9tdI.wLLK+)I

oߤH]R+{*ھ${Ϳ;hɖAk<ȴqt\v^/_8/Ci}0ߵAgYH}Ҋ	+p&ULO>l(h|`r-ZvaT1Єl(?C$Շ'$5X:`FNobk<ٶx
~iQFh
Z2K'6Zgf)cuNEM(Z`5&c0a*Ǩj4܇+Z#12UVGwlŢ0Rq:IQsrD-4`1a)}J޵
1_L߁{0:nJN$I|=d!i'?%R-)Q{7I,?sYL&+xH)"RS[-$&,U8
ǤCn$Cb2YT( 
,}[L&+2uDc]Böx^lek7tق'bntC& ͘MDέK:bP`P$C1 g&-XG.8{v쩸&7o{|owr>n@޴_{E	6HnZ o[w'YD6!{syx$j+#pYCCO3cŞ⸠-4z$.1xNgP3@]NґΘ%9V۹%U1A\R'D0cX$7ahϺbR'lŌtȝ!IǠp0u#M6i;\Jj+]D[vXM\8΢P 3sx,2sDq3EΣUqBk8bOD;:k~\/l!*dNvt5{mKl"p#.'tq0e	9ARiDgc2NX?-KʆR$yX9\=)~B~.
a'GRH2N8$DçETNz/	(\EAEj*q_]eڢ5Jixw~Ik'3pKv<<SKsi&_RʝN+`ت}8N81C'\ޔ_dz4YKc=@iNc	kDZ>A-j GKh1\L>7dłtƫ8a<혭9	ih8,t~.60NRrASCH *bj?*uz=ZW<GW-_sYBwҪ8a;>R̠=ѳFd{Idcg#cN)ĴVO3jБDJs5"ŔPˡ^AyoYtAO6DHJ<ADZh,vQE`D=/tcF}Ebl29DV~54e_:&~RU#*p6rW^j
ʻ\n)yۉta:՛L</HIQd_xa:i)ЁJʠJ"-X6mOs%3ԅY67Hf=5|aZB+6޹9t1SuUY[gMpBI'y5=XqLmZOℝWp;'S?'JD))}`&ts:x^mL[U
(qV-c8@2tm
U"FBᮽLsAѺư}`ɌL/Ydm9D{ߛ4/snNޱ)QV?̇@rC\p!0BvnM9d)*w4dfl2Jst$ E+}<NX:,vYd(ٝvnOyJwvTTϡ.)qhu4TA҉mݕ1&\J)(2M(Ae{d+;	~w8o6!훠Ud˃ł貺D*ҡy&dHI(=e6H(/$EN;EhCc_6;jRFlnl-v>hRFǥf:FzBxʒ=xjǎ&n-VG/$?%|ywsq:ݒLݔ+Ԣ&foPD&}oՁ^3zMhy6eS+?.??9tz3e̓z:	ͷ"No7׏qNo(R77,$/NHS=&,u"<ET&|> t]f߸QA;!in
S=Jg<\-vGAX.Ջ=ɓicMV}/3IL3W>eFBrl3?tty`oXM~ZZǲl˘KL1eب2Y),Y0QKa.}#لqK<#q&YxarVJ/pP.s[p&RI(,ίSϫTIufΰ=R
Gհ,{8R
[>,Kż)ma<lT]R뭕a)ZI@((.mN9[NlYAƷ9>GsٲX%fo[p#H	 dң%Y\==لkXbyy4$*vhx2zP&Ddс[팀f V?OTϡ(l{yP{ۦx%n=L˳	pܣd	מ7,N˂/h.;aΆxʾE0i~Qut-C7B.6ʺI5_}x^{L[Uߡ0-<ÈM3XLPI@mB_CAf..E,c4
 ˖?fpbD	sǄmn9I{>󸧋+\VGQq>ؕ
̸ȕI.eW/"\vrltbX~IldəY[ c&)7Q(Ù-N]t	1Zz<icҸr>y_ce':dw!DJよgVQ,~oIUvDj:VlH#"Q"c?UGΜbp
,aKD,6hR!;RS'z:H8
)BNz4"P:eKqo #~?NjI{,:~"Z" r
hqqܲ'+* zV⢕k ᄼem+k)$髅4vvXjcL	+TSߥhF"Dի
X4ﻧ1P(/#r,d9P|wىj,}Q煊@E:AHW=:	v4c43lLۑXZ5nq	yM0lGz3'X8Lz6vCzlus:N	q9?KB,SL 18̖/N9fA'	~N ŭ}1NWjT:X6~`tFu!4hE48}npk'qY:&"鹔G)vCʆ)8巷]n*9ӷY8Sa<^!eǔf^BT챃CW|t,yuujG$2r4TjtJ\O
3LVw[q㡶<̣ȭ<c6`a5KHZpy>J$XRAVMbi%qE몭O'br]^gm{)[:QaP\o4<o=;dlq*ic?G~ydt?*MG=l+)ߺ!5pV礔!uSamQnkjChaXM>,eN=PE	=F(e=hWT/hyY؞#nٹ	2%oCI28bt1;dA{8,bP
:8āVP<**Dքx^Hg4hLjX]Lbgծjܬ?rw"c2UO6&cXʤ?Jf2etR8ƺ{	׃y`JIb4*[ =gvyQ8MC"8G = UYWߡNh]#%<"*-Nv&z4ڱd䒊 9|ęy9sgh]NgNĘC9QMEiSN#ZX'40gka`ILG\36Nα,HG\2+e^ڔpB^oy+Q>)b}!)̻0#gqf}	00-p3\`gIYP.al-2t4kgQ	'+Pq6Tdʘ;,Nл{*x+6kgUwqĬ6oWB0~q0)V	91>H&>MfH	8ҳفs.We09H#8~XRk[VPD'[ ^,k[fZuڍ~f,S(y,azz|JpoW#@عvƶ/PƁ6ʲ1|zM:k56D<DYwo^/&S5r޲RX4B53^<NNS֫T)HH<)?De`.:'g#QQC"1qU:g8qI&ˋkPH,L\7E{	I,	vNI$UOŨL?IBƛ}	C^}Nϱvm
2XqY׌O)]XzՄz}QVeo"a;neM/!CCmw)'L?#B9 ̰FFӓLjvV	3X_8%HT2ؿVp-0w{+p24d[4NC^l0ET1cЧ7a).LK\yc1IִXr3{[9@MXT">B;[ǰ{i1L`/T`6Dm0\oujkGa
k<Z!ҫ}#C.5ȓ'DwUFWګheb)uK2rT}:-FsH8Y$cC&@,xPx^LuڣQ;J; "sہ?[lͭ9\aZS"\#u92\9?9}?g{޳׾?ڄD^m!%i`nۼCnPb"OdDk7].]itxAS	whz''׶'ئjqUӋ?[@'-w5ɛo*;Uzf7NޓcrXayg!LwNsE	&Z:(rrS[àJ#%&?FE]L=c친ٹ穇Y-MpQF
f!Ј4a7e2
-⌝16TP&Q&3EL5cfSV54aƐ<Ie&qڡ\7VpZ4c?h&\LnaGp~+c4n\.aLUPճwΖ^Z#!lp}7w89Pݯh*cLMYhaVU0h:ʡA,	V@	ǆρl9hE{;>+}(4Kǜ=Fc̹|L^ZЭcf'͎63KXK4/T#s3JZ.e:]צ3>Z0͋⌍18Szkik)3HWga	(cX+8s2Ӛ-&4hf[nS9_m[ji¤h8;!<ZeM5];MK=lv	t4/73.rfB/҄Ndojp̓Z0q?:Wqf&\1#ӁF<Őjit0ΤW9D҄
d:!=?Z4AǴS˘93F	]:1&5 (M9/Osx엛&0Z3XOǧ0Υ?d7fn(xdoZwrG&|A.1޾#>t0i}?˚]%05D=IɹS3Je5767Nx^{lSUؓǜac!ִ]
F;tcsqmFсHC?xG `1GFDqa4B 	$`ϯ=`N|9|\˜!_i24לoբ"Mhr-aDהze-|gՠx943״h*/aeqf&c6$cY-M2S!>rc@i-҄+ѴlǧTfv	w4̫o3Fܘ̙ܻ&LG`omNZc]ji2-O38iI[t,e&(cLSg*7]ZPIjg,*wKXK)'XqmUr)&l0o8SΘXa-ML=sř
?*_Mc40\?"Amq@d?ӄt<ۍwEŜɪ=4!Ok-ffC05]Z>F+~s̕-	-IR"d2eb`'ۅr IFuZ:ސtCLWĵmTl	=1- cL&kirdU*d'ue9ޕЬSX"Ax/&ЋIqwF:+lb#J@lb4+sj۝̼iFs4!BʹL]J;zU;f!ӄ{c1m%zz`߻iCÂG79aYηa3Mx6Ib.8suDh4J9AwLƩ?̯2"фLo;*MoTф;(/4uEK]~ُC*ҹh#	'v5E2K9lQh¥^ʼ=X㨺Gނ4eRmzMCݥh!7WO~5H		'[?Y}ZPZXA
-#bK#3I[椿q<ar2iP]rj[g'ӚiX-Skڝz׳~ZcruNk@5E9Ix^heǟؔ%4kl5qit!kڎmj[bks4Klp:DEf:lPHDl6'XAС"μOfsw|ydE肮ACf}%w-1.^w$[C#QPJ1mw@C #|lTI3yo'ĬЧNIMQDBBwB+8:s7nNƽ/ZQC[ϡP߀ 5+JWɐj4EX9Q0g!0g]CwUH	Z!Tb425jxAOX}XXO'܃11v}*ݔ,m'HNDѸfwk8l^:hezu,[hW6ʲN--̲[ZFD*ML-%gv[2Kw5Z4*?%nyYn6p˫T4YOYl25&SMIV\c-\S4!E5RYad)8jKN4rVqi\4mXfq2D,MX2w-ha_f}4i4.Fj󚉋&dT`Z?"*Rx?	7M9la<{-[&xWnkXe(^.nT҄:o2aa+zkloaiBjFlhμ]K+*~|N'e-v4ٚ/Z^hu2[W`1'FۮMz>k]sMݶbAfYkqy`BYvs&d}T/A۹ѻ[bCrBE4!E-.GVX#&,,}[JW.b	-l5hk䤅5Ώk\CR҄H+GQ:Y4yfuQ]mSZX1n\;/oI4F1H;yXh?bSd%*Tʛ*~b]p)}	aS8DS$ZWwx^Le {!0%ZVwo/;ԥ&6HVhK,7McAJeipυsv~}>tXvqgƁnpxQ(Sԯ5jǱx߂v;eKe:\k._[q$9RM,P"x%%`w;2ZgϯTup$k<=
324!%
_}+T `xVu9èAGe,a^!it,Jp廿n"Aq
9Wzс'cgpKm:pFWXt,BN=};WE8lTF}$s=.`HYHѭK_G׍GO#3_^5VChbC%ŖobN}Ɇ[x5I+'FWWTx<yRalSQԧ0FrXٺ#*QW3[K ݖ:qؠ^g6H-8la\cIEU9"/ 2g6I]!A%IC$rᮿ[l~cpwAB{f~
7VWR;Ѡ=H_LFۃ=\xI^6$<rOt"fnlBfI]ؐ5,+~; ,h9Τs=ɡ2l:$%"e,o$ܣv#co!~^]K2U<pѐorvyVfZk,Z8ȫmߊȚG LkRr4>$+CԦ:Y4=%^S8ukj
hfPN wZX$p}ޠ )'b:ϗ!)cM,xQvHwwCy4IңYaXrEX,:lU8;%rh.KGXYlAIod3qRNL}Hrj7mLT􋾐}_Y-e^i,	3GQKDR"|v?LGBK٤8 HTr:8K4TL:dOR	Gpa:/4Ϻ{iއϣtkvLlA=7gkF#KGq9&bxlI'_Ot)	Srʊ;c14u75b6G}FLӑ2T($Q-ektۚgvgzMx< F"wnO?.LGtPJ+H"NIN\O2fq:dkk5[s1&RkUI9RszB\ ) )^x^klU3vQp۔.nYRhmbQvgv,hbb1BƘP$@1`
AX,(J0:tZ|LNNrfܙ93֒<"@v?A?bipl<BGGMUɕS|Z0P:*q,	*R@#T*}~
gb=&=?ÉvgPgtfٶ+u,Dt4I
ݴIŢFC4(F?la+cV_Gv+^](s'|>"ZexD=NJ?L=;@W)9\hˍΨU?-W.Jp/Lb/fN`(%`+\f]N׆yzg+%aqkķfR¬_H&@03b2i
ʪ<!#7orQ0G{dznh;kK֡I7F{H3hqu6.>ͯ~$f_DJ'"ؠ]/dy43(`x+IԪ99NТ=l1X.J6_ 'k֝Pwd4,Ggz+t+c%@= d&7L{8kr&maKȃX5NզF\kv|3zD"JD"kqհӫ_"OhL'x0l*Y;{BEazUyh]f<Z"%(T	o1ڃnXelY<nyNBPʲTL}()ڃcg+Vo@	7L.Zg%a]oŁO\pn5y@z}"t>$|XT̈́j!Ňo<Olb
@mjR5w}]"wFفClz2"Ac٨rq.s9@<ʜɿ6J҈V7.gVƲy܌k)avFv6XB?a~faa,[eX,djVh+aVr[ʝ۬$060Qc]~I_`4ϚlFbtnLOV2yM\lQhu'OR549}^X`=\bC<\}/"NJeh3GSsuY|[U7hPl8l#=98VR
>Ew G3ީ$lW|j%B䥟őc;ja )2x^leZ[Q2m֭-Htfh`]c-ĈAKMD(	6ĈS'f4 ?f	lωy/ii}?y}
!uxAf&WhZ^x4'}wOH4awٟc}U	@Kj*ftq	J
6ӄ)*;!$ՀfȆ9j&҄
eCbUCF[tr~VycOUaB	jztb(an7FfxG"VLƇYxc!+̤+kx%m*Ս-/Ly`WJ6:1eeU3
aqn-vӄ>jIЭ	s'0Բ^8f%4YEYm}C+.`1MB!+˒"Pf.1=mcbx<T\v{iB:s7Z$x!.g5EMnzc{ Mh?D*| -m-L:pK%峵y&DI7IiT	%ΤuTy5ӄYyj4xzB<+yLnYjhiBjBgw[q%7x2sc	hB1ʜng:s湗V.c45HL;;{hS7҄Ôq-Kh01ƌE9s*҄cϪqf9c.'-4+=
>Xro҄iǥ3x]ƙ4aqN%t4m3u_&4RU0Hz2csMw#l9҄9}$<Nɩa0i.ۅ&.iQN\4k|&'Mh4p=,Ԁ2:d-kiB'eGngB?i%Pb>M9NjLZg<Wϼ4*j!5
l	_:!kl&gWyCwNbpBo@`$x*8~k	qbxDٱ;G&w8?sD#Q91,	%caP
5_;#Kr8bIL'?y&ek|t+\4cv~*jN3yh+XL;)x^]LW3" 5}(Hw- T#R+҂\&df6Z$5ZC(_EmmVQÆMKbbSmІ=˝4lιwK`\ջ^YS:bz{HSdZ{/MqjI'N>ȃyr逘ܩ0e+aUz*'Dʊ263g͏K4!DЇ"1^9wE7&A)\
JH>6oȡ+wO-fZ*+%~ǿ'P6{-tsqx=1MgVv\stR_𑛋D 7ttGzQ8D{xH`<SDrPO`I2k+0=Rs媪3goYYg!ݪAKqKD4=ڶv:=iӖ[,6siУ+mzPpVS4MT16rf;9<	-B	LMP:jiB3o
)rWnݫ8TZ)	[(y!L(\I͚&[EaFlvNኝYΝ#Ӱե	Ctbtz(Ӳ4cuh;4'j~m}3X&+Dp$v/KPd	r {U{< [~r71).UB2,Ll;&.pMM>7ښ6a_-4Af.130{TX|LmjpV	,1->P[8M8janӣ-gaoi¨E:*&P0J0oŲ]qYo4 =t^&PS(b@oDG"XJyw#u'F%;a6зI&ЦhZɒ1ngV&TS&i֞#u:3{3,MhЛ1729i,MjZęr\2wF,MP)c?f0Ǐ9%,M8k5[Qd]y ?tΏ]L&XB]؃K?l]F%	_Y͟	aƑ/Qj~k~27ui}P}-t)x2UK\ԱBqCׂ	i	.4!2ϯ
I!RSġiRT|-:x^{hSW_V[оV^6MkZ_FZ I*CRÉ")`fUݬoDrNz;sKr{ޢD~8t:ȍ
uȕnn(M=B~7%)Ke6{u2`rSG"RFeVI5NXQb4h%eݿ13w_7λIi &͘7'lLqf1af2'LatcV%@jq/I%]Ę?Z0C3YeN/8!i3Ǆ1WFjh-N(~0gSsn'TbrPg		fǅ<Rcf;[0e804;z<L 	g9fSXcVOZ0ez<[r&6Zp#IZM/ }=Vޙ!)	$f&h^kI-NÌjF+}E0Zb"8fA8-QÔуs1i 8acy-̔ӧ9j;{i-NL5roc8*3+3t3RGJ	٘8J}Ki<ޙ0p5Ӡoh,䊃[5YB}c.$l?%\Ab%_<f6eF&Kq^K3CYcxH&}cXeNSڨjFfS%\s"]-Jۣ䙚'ytX2Ld5FV=KO:[[Aɴ&/iurj=Y;hw@HRg]SWJ(lt5?,vj/ê=db40!f:T`iNW4ZW+dgjOGsxb6/O4uTW@Cx5G^7;ey;Dfx^]L[eh)5-$KTĹlPq)+ot(Y&LCc&^ehn#1L%^[y%'myHVxq'1:;lZZ^ZFTW]{V秫_ع26`#Oi6Àxn+Bnn%"	ѭ!5R"'Go*!Z	<U;*'Φ
?T"ϪV^O]LI4m9}4.d&1ML	qk	3%gl^Vg譳fJ#wKOefcY!üSZ>BK+-kJT;ʔ%\9:+҄(\eqƞ,Z=e.jΔ~W4eLYLgΏvb-MLn,\οTpfܱkiOiY0윕҄?V13!EYݢ5_/,	e<f1Occmw0P?qa+E\r\l4}xNhXa`}\bki>\.433(f4!H&qoʫC%&D'Rg=Z~u*JY1M66BEΙ	'|m.oZ9Z	?|@Nc?QUc{vwYõӷ[0s3}lDUŻm7etO54em}HR40w}?X9NӃ/1rD&x./b4]OR)P(.+*sq)i	H}"Bҧy4MyN!-2踙C9ϵb1MH&ո!-(2ȡ[XLf|I0[ҧ]bRB{2!җ[l&|N%k$+tG.m
L ps[;t&%<D6f J$ݍ3卑s254LĹ}PA"*0.r]brl@YgM&iy
<8csy	ӫ YKrՄx^{LSW ҇<:I: {PGD6Fq!mYI:guN3LpȄf%q$z=^|9sj _fL/bĺ.m86Yb5տ[j¼_F$C)+\%/:y	am&Z};-p6Ĩcp#&KZ9fAZK[^$HSZmC<Ad93sv9#u}D r-ᒱzt!#\$`d`9䌭sgр%͑t')8֧%YW_9&}u2"tm=%&#܌d"BےTl'KbLhpMldݩHϏǙ:{˄cm&B2݆ˍ#9KNV$s3DWNdR2wQmKX߲6#RVxFJG#ٽb)Пz
FGQO_ɜ$Ae<%tPbUG%xी[%d/RlVaqCfh1BǣNWX+[
+n7e{]AG/pF8=>[٪V@GFs!#O@W7CwL<sD@+HD+!t􎘏7uqHGo'ǎ1%sc$!>k1D:DҞ 4L;ʪ[J%Yn+#xLeFhMЯdAN֊v\<<|`d<wx**)i;AAvFNLև}!1l ((^	A5k"1͜q1uQ+hsN
xݲkBDJ(/}gPBGb'nU381GB4))9#I;/>w7OOc2B#)[\և]dE|ETђSiLpT0'rh$$%fEܗ^P-ݯSm_b5gMguVAޡ,˄YQQ|^@DZqGQ}/ZJPup,[.ǅ$XCIM֪+JIiӹ2caJ> TAB x^hgU4mk?pƭu0]f*vtlX2I.\$ujVq0:eMiaDlPܘl]py{oW }/W}\y!yIOh-خo杹7ڡwcFMg?L?*ly8D+Ht|T2}MVl	{wֽ/.!5Rj0$pk	d,LXO'꫅6YBfbkwJ+oZi9k	=TJ+q!,u(|5.8͚ird=sHMK RQ:b!YUvNw_{i§ɜ8nC+&'M
p^sikP&6w޷V,It6K;zX3MP-Kv҃#&$u͖KJDi<{Q5iL=K2\b4OUBk*
oWR*K4(ɠJe28S[ӕ4!Iяզ;˅QI]Ǖ?r&Og8Ds~}ji$8S]L_gfv`-M2)շDpG|>jM_.s۬Eq`^K~ȞpcXO:ǟߟҀp89!
ñmg#jpǍL8D'	y\0{yLj侹]at3>VK(cL;(eoKGiEoJM5֟*=> ;\.)EηQI HlI_lg܀3n(1.ф䚿%4OP;؂Ss?,9dZp˚7PBF
Gw9V}Gu&=QS%?7DJ$}*1ǅ7!F^fJ|^had7#[rpq;kX;MȡydۤZ)sc~l	uINTlbN P5\;0vД'1- S+X-MhLDtڵ`]A]ɀjײtUE\_ _ UzmR]-!5CMMg9+	:";ݿp̈́x^oLe]B[,c1Fu "Q"!V#:_h]6^L?sdȌFDK⋽Udl^^,Fq q4~u7Or}ݯM^ht$06`Y<<_wElɑJ4<_W̺Zpx)buV%(
¸*a`'eqB1f20.HCڷHF;hne'H7WJzH돯(X)UIDj\QRodUңDV6Uԉ4cEisڜ2Nq	%ۈ3YM_I.N#ݹqBBBJ-DㄽyحJ>n52i97OĠe\2AhIxit&GbtIr|2LB&x!?ipZPDIƼKuI'uI*r ѥ\&i,yYRi&Cv3Ø?$EJN7"&ٞ<0C]$6o'ͻ^6jOMM%u0}r p	4#sqB0*jD!PA[k{ia0!A+}Com6XJԜF!pqmӭ,r@/>jlmiPJJg@~1;ۻ)PLP0j"[Mji1(=+jrHVTCՔ-3Ǩ:׫K֦==.:sboL6䨮Ģחs⽍dcP1&΃XX"&-[ϬaZ'hi4E>/ƭ\ᄳEL'^)6bS_>Ji\C-0clڛ`$-ff*ͭ]U=;ۇµe	+De]MgSnٷ'd\r&"J$ؙmq8!c\;|!6&k70t!Y\ʜE!BKg} -\b?K 61<}n4nV'^𱋬N:qWGrQTZƠ7|Ai5x 	9j NN[U0aP83BƜ{Iai-?)1"Fmha\eEx^Le{? @NʥHr1DD޻VZH93uM+ZeH-yH2t9r-LH}9sw{ݳ}ϟ}@%/
iҒC:?D<zw]z'iCN1*~^7L/ݦb	=eԀmNI&5c2ZJR]b`9;A^nh:zj'n$m(3(WvU7)gq(YՊG[+j/5;|N҆]wb [3=|K4>4t9,.kQ/:jz:T1QyG'|)bdҡ%ĵLH2e\NxBnkY8ZQ6A64bi<a7yKsXjdrY)>Qr&-~]9cGڰ;O_a,ץ!I%9	B*ґܹ~d^)IKJ4?&75IB=#D8*N'Pug|ӞGTq7ݙW,	ޥ,W<F$L'|@K;>b*Z-
N(7B؄ߋO8{d|)}ޮ^No>,;NI9Wz(X9VD]]j\BѤpuޠO53"Qi?xɩ}$ma=+qUpԟhkfoAd#7T6LD	ZQelyE	Cр0m\*K'lxf&0nSt{N[D s.yro̸Ǯk>Ic~̕/-zQ쾎)bHwC	3`aA4YіO+$=Vp;?IK&&vRh!/wz Û
H-ݸETJqr:
P}:}r!oRe7kZx֝J5:9!%k(I<%)f^Fʉ8IRõK7لMf$[o*Eӈ3CF=3
d4UxWՕ5N=U㐢Sbs4wVq0҆^jT9E7(g1-E
x^LSWW[1!"ŷk*JTFnE(m[3FͰ946N3F-nnJ5!S2p39tzܤ9s ;lrTN|Mg~r6{`BIH鳐[	drz.̡eD<UׯR)F2lv	ZeY4T}W{F2ЊC&,gNlG\D=;9ΏE,|'%טBK,1M".y*wp$1?JoalШ2X!Rڦ:lYrlm꠹7ٰr$ e,皿p;+ЌdR K䳺c^õOxF/G2ӥ(7]&h,HDdWMx$6J#ZV׹&A9E}ts;oH^ZQ,75tb`7&E/OYƑ5X&G	aH#HKq{ad &ĳHJXE}0 x,>LA!gAGg|K((H:j#9yY{/y|=u@BK,\Qo/C4u욏Wx%.asѣ|k%TA}]F<g#x?6F`wXxiK-YFF ZPksH2xwTշ;q]ÕQ.Ob!za5"j\*Խ5՞xH>?k:&= M2uf1o|/T gEw!<@f?.K_36Qx"CYlծը*->Rq-.E~P}&Uu='Z%X#~ZWU#_paf,/Lch_{!R*Z$=C\˱G	%m.K9c`dJב>r$uzdi,VÆ 6_3y2ܠzZy^Q	i'%{б7༘yF&
kS-z~'o$C^ze>C^3Ɓ n iǣi&K{H}z.wwZLǘ5yKW'=tybb9o\<I"8gRGJu6j,2xMaj5D#TF5t3pp9-үCw6ݟ3#ɠQdF#rC[$=|ҁ5R^e$SKv7 WY`-cm7^#t-j15I
Zw	jF\4׉m%PuGxJC>/^vUB 
T'k5,x^LSWJa" v5,6B	L*PaږjL?4Q%ldљt,јek6m?0$˶dvFKKo^{޹dKԵwtX߽ow6
n|SBCt91몶	B'QI2L/?ʓ`7aFvg˔B$ݑ*o.!r(Sn!%Bau3K_ŦyVGABrV[,"GrFi=ye	)`{عLo>|JRΖaPmN_
}eA8
kTgV?=M[eAQesyl=I)蚞O9:~PiyNo9b遴ۊYhBp'r.}$usFn ;o8ӄu$RNWЏ巰,Mx2Yj'lk21)vKq,VpJ}z1#I#KYi)1>-H9Et
kX&u@X0x^ZʱsL=8Ml#جbӇJNb۔&eʝu"
F|]x,Mش3Bpd3jV&<X&r*3dL4]9gv]aY6[ci8S3iƲ4F7=SϘÜ=ò4aeTSe7rfhq+Kb>W.9]ԍeiepIaG X{s	+t5_zq҄(w#@HÙs!,KdwBi`̇m!ei§2f)&>i8t4)*aeio>x8ZH3+rV&38uGLxiB>eww?C陾ei2ReqGVƙw,Mb8Ș3C{X&e⌙1hӌ	-+K1Zl;G˴yӄ^Yf9cv7&IpȆ`XpD3/ωC/`Y0![MI;ڂ;VMaYp2Jˬis-s<҄2t[8;̳K!Mx^}LeÕvA58 3!*6a2Qh^dl̄݆X.-̏H!-2dEAb!qf*'޶xɓ\{A.ʷv<"9r.>RV$Nqvu0x Sx]mg<4?NȃKGH4` M_Aռ1DX:Bv]\r>}<BTAYa09k5x:$sKGNk<Tj|fi܍ lLU"6DUycpGÉiP/y3D9ҍP݂_Ea~6bW5P}BTD$Z@ܓ7|3]cOL[55ƻ<26b`|G]h:ԐQbR=mXAPƚNYP0t\-OYa&T׆=h:XѰGvSudݧ4aG6,GsļE=`7LPx@@DAL[$yp2MiZeOvKrAq<}49p+$q7]z'V^}eu.嚅v.TWɿ}vms{gH2ʴ۝ze2=^~)ղpk Q/=P,$rQXUԗýBu>|pfW(?ZIUd9bJ .chrӜ""9Ѣu/q,D;N/!pp,*"vXHUt)ڗzה3XU܃V!&,+gijj-Xj&1v$E|u_CՓS`k὾سȩ	=p]!9TG=k4C&];xw)8bU1?cdkm^AmK{4Y߁lHpGC]=ebӃb'swP	=ouG%n$i<=]^#_+Aܗ0C{
ͿIP6:lۗvC׼kAnNq)ȑ:hPLb*InIƚO,ބ}S4$MdnX,m2qb6aoB/x^HW ,:MfIvsjleYiN\NA-+Y0 
"tE̱ֆSX{5}u~|yp|?|{l^ـK&vBO <`>Mmu{L	azTɬ[A;HkR\pIzhmVCDhyN8 ^?=맷K<L44۬-n	;aU8o%q9tKHWF@FnjTk5nNhV):"Ԯʫk*6mhT~ǁyZX3nB]CoM(C=2lw:ZrM>a(2/.<v-%2[/>$I&k&u`x3$~ϼ|ZVNZ-gn5{߸pf$K3nK5+ٵ;C@P6e:^\"J<G6u;GxEq,h}GϮ-5af2F|U)
j)Oi%ް8YDaxU<D%"l}ZP@s']63B>A(N2YMZ)Un]1%%*/Abբ`(&LoJUK \ɺui<Զ+,͖{A"%Khl+%H)zQVƅzY(k[w-Ym4'd뎱:=dQ^ʄv#<vUאּ%2	''l9	1&>Hڼ=x|C٘[,\@*]mR{@P^Q]]\9c$o^߰<rKr& WL@>zMFM3qWK=<`>+n	Hb6.f|C*zdgwO!K 2t1<G|j>JWʗ8-֣%8F|cu-TJ2'if#J];y$gE15^NF1Pwdĭsy'6@2ogǝt[XUHL}}NSC0c{&̸*142ANNV*ܱ# FC6pf;l%2y#ڤXAAC$֓%ENG!O/&HQP"Xw<\SDqGF0ʶ"~P=ˡXe&jygf#^&G.z$ XMx^LuB'!LCP~dR!~q<w͜6SX'%[Bj՚L[.K˴Y_{|?}?@;^<	?}ܢ̏AҖy&IvI
riP)R'T$3fw0q!q;uz"GWIB}$'4UN|V:r-viTy~bwYXy|'A$O$EqB!N.eAwAĚɤ0NP܆TH7$ݶ&ԖBR'I|Ind꾥s uu<9qK~ʼ2gٽ	A$0q \f󁄱j.א=1l74"ߥ3N!)&bd\kŠ-DRGNXXpĤ	,st״ŚʮV}iVZs |VD%p!i>A#B]DN0CM(fP vs9[m(֛OhLֵLhk0\FZd%,$rU&{DN)8X=]|"p}S,P<TuJArF[,G7%gAMɠ4&HGA\/q:Pg	WY8;Dk'?N(>>o^-ԓP+0S{6Npt!/R'͠8'rnTQkMPLQȺγ@Z#BQJ0>D #&}L-H>qա|BR|+}J8
b?*`QcfWǝZdܩcqޜ!n qm5G9y	v18\m1P##T6~@kc?ȆF)a#^k7LY-n:"([d8av6c rStZԎT>uzHzlƝlRdVn@6]4)pd^ҕ'RXHתwxmݕLO/^l5<x`<ϹfϿ<PxƲLfn5-z/;tK,J7B~3LXZ'asED#5\Q	kCL;~+	,-rAZ)B*uz-}|19
?J7x^lSU*FQci+ tk7[[kc"^^W:cQ0d#ƨ12?nP̘hTwoߓԦMniҜO}ܾk\0tl6ˁz!P?Tn?C~f^O[܍52NIJ'Bi+fNXW$eLyyt	닜t^	]E/ӕ8B篮[ENM8NƓ`riwwP[A$qC@fTT]INn8aK7Y*H);mBVeFR'RZY3$LDr8:F/Y݀C346!(6,	"tN1i&=m}}9cVQ)cTzNy&R'\m؃2TPSih}	3Z]w]$dӴ2޽5JI!/$-+Xz2J,@V}C9wς,֑ziGE0N &i{-0NufJm]2+a)?Kn	A<dVx8'd[8O<bHGA^3
N8)~0~]GoR0ȡ\USHLHwϿ@+auI%;}Zj<*2;Mr}6;FEUWB2?T'DQ{~-%b2~\A;.k ?ES"Ȩ#e R@N[	pGF낅eTILhЇ }9	d`n	d1ͺ]Oʘ!L~t\-s@F=utMT˷w/)lN6'"JCL_NMVLpQ^|wgHe0GvHb$ƨM*Kc_bDѕ7GHUk.V~¤@RJ:{sE=cȂlp~̥y
;cwB:F9],]YA:IЩRCۃ2Qs6/qOH{x^mlSU[n{aѱfcs#6̔4ݚAP[z嶽vBE04O,ƈHtq,0KqA3H?4{AirO9sO >~4vpWNyhv\~?-X@N]GHKF@03qZ 45L3?౪X8o~{y%'P@i!gjc֮P3AhJsăiX]C]Jlg/pB!4<D,Rd ̠[I1N=9?dBG:&ԦzҌ^ɟn%pݰAM'}ɸy䰚
ƘGO<TCjqF'!^LdʬaU{n%	@LqcX<TeĸN[4wuT]E@HQil1SgaS%bdw1,	0Zc`K ]btN&Pc턩-֙cZK!A<P]fС-i1N(:S9Ӌ*朻V^`<T@_%P:RC˴'K5uV"D4{B3	UxLO6~G*Eo5茯s>8ߢ>w:nІ3lx0]rŠLGlL6^;=g\:ly\i΁v˱.Bqz,Y,:1bnZ:B0}^JT[_ 8fAh{i$L*Ν+^p'fNX'בJ IѦJL4JqBK}gyRpv{y3t޸℅/&Ƀ<vTTbj*AΤ־̃'O#w8VpmRTLҌb\)y$3C"ER@zyo3WfăXu*P:^[tbzv	a$l}RsxN䁬U/1r&CqBKe8o"R˗ONH'g=IQDze_[#*}q&0sYvp7,#?gx^Lu#	܁
0' -<":i#<Е,\Nici92tIIBH&֚ӶV3Ӻ<_}l{nk|UI+l|фYs\y2D^K.ăw<@
{^++/DJ|VS5dJiLR4,Nx/IyXÌ,!!1|	O}{׉	Z\bn4Cͩy}'u>-މz{OLk%[X$x9(h	J 4@g(eD:(ygi\ܴ"ΌtK7-)#ztB#GP|nb=cZW61Xkc,ғR6=nU^V0ϳzs2m@w[BL]wy&*<=J?6RH(Rq7>BAR!KNoX)mRLK
UWr0ʯnl&:%AUY9sy@ŮmPXrϐ|=Hy9"Xn#sm O"/	ڶeGW˶o96z4s~IfcJg.LT,Nkl'cqA֑:L5u^:yy-I|<~QT-(n")$&8QthivH	Wy\mRR㾗XXE`jvS :pƞA>Hy+Eټ}f*v\mW5{ff{D20I!휡^tî/Np]zzcs"xrP#VOkHiaTPThHV
P^Ttف~$I"7]7veqB|;bf\E(P_Ty0eiZH	VMI8S?l=(QPVQv4PP]^'ڎ'*
*ңh LgBZ8Ay4hEF04&hHT<8垖{إ6zD{+j^'RLdYj	tNwqJ4:tp?C١JUJ;J[	_`h.v^8Cicw-8B^׼]`A`qk/([r	C:o쿃QgIx^mPTUge]xqŕ1ÉA^BN4P3}/]h&99_4^,Ɉs5)*mht9{Oڙ;9<?{=l$ZF(YO:sT=eNdJb^\9BG(krܣRo'qyT|>syAKrOi<V486r^x ؞JB{K'RHi`x\hH0VV5͐sUSWH{ѽS<ۆ8RPt0gsgf2fs4,Iapt玞duS9wU&uqvW8-qlD,g8%zgT<&4opB5Q*ۋ>	$zױ-Z;8ĂIl8q΄XpP/EL1l*^K℄	|u7N	Dr&fiFbGͮV}68aЩ)zYQ
/3	`*牪0e6IhI#%.DoH	GMU-$6[bls	"*<EipXIQEG+$:Ճ*Ҁ64h2E24Τ2 g	iK?C$<Y%s:v.<k#ةw_.G	iƭw^GS	qCYgsBnJқA3RIa`DPY͹d-9(d6-0soY

)4̠L-	%uqBq-lg	"}Tut.h2|NtbAB50omMg'HnV7o7OMU;:Ab*Vs~'W@z(߮RI
.Khv繽7k4':4?֡n}1<%|	Zy+J$#X;Mr@01]KՇr5}V"IOئ$r6Ń=ꯉ;&[}KZ*t5Ma>qS\.u{y&1Ƌⶭ{'bk\/	ߦ~ɲB܄s&f?-PӼP5 ddTx^{lU3K-
ۦJQ䑰M[j*}@!Kjk̴;3nQl14
 J$Ĩ41@"ִ *"(i@)ν3&M&L29_νwLΪ7`e`8J6i#T~YHHMBD#|8LK޲ܓ9R̌yY,7x(Q=%}7]ě\CĒ-RTcoN'q[J^n+P'YPV8aJ.:YɐP#@`9~|R'agEl,u_T%"Oc'}tAH]pw${s?o,w`TqĉNRX*X(,o_%inegsIm>fUelK?p#qBj
Rֵ1Qi~T_[!?ZD}&rLdŎFV:Z\M$>GoK.~wCM61Q貅Gd^Y&p/ыLqAmI-ofu	1Ԕ3C"	L{Ï5=iйQŇN2Q.BiV
u$#'P2z[R*Y#Va:FO
uJ'Pҩ=H̞ڔ:pB?;F=	jP(TnCq~p6)b9cAyVP5Y)^860SJXDyJ-tZԚ58᝕mM-V琺8;K:˘%9a	Eԩ_NԖv3Ru5!uw~#xH\Ng\Q=iA6С@:u䡒ji\8.Ηfj}$ZYRӟι2NZ/M.&h*T˒Ph!D{~f|˭؅Fv`G5lcZD7h:D,e=u>~"WrMd-ZndUt'yotpA?X#9h\qeo׽}ъ6$WbJ|GS)),MVl@$S7ӹ0RBdӓ9@[q(vR~guuW_D8G΃)s'YN5.NhN39Ɛ	ͿRkF)}L=1rTWfKtX~"$|{miQ'~pK^D_nFx^oLe!0695
-0u l6Qε;
hD^Sys#`E-d$[\Ld3~iq<{wѕf 'L\7?) n-l
L)&i\IZEF(CP)n|u9Vpjs[2;ln;2HB]'&{\a&/4ViW@,7(A㳣\P2pރQQQǟ݇vZcur{-]jk.Jm5NHԡ̇h|oڭ9jۭꅴܫK$]E\_5	^Z\RRRbI
μId*
8{Hm]1DlW'P{*]
"tx>PgAf5*MDId9cK3y8;5O1(
(*Tx4^PRn(̉{ML'tk7d?wFn1@r-k.-udkh:s%ImR'Gczƕmrjv:YnڱoHj O"i'Ҍl}L?2%L&\av
jqߏ>zt5!/z졐R9?NR98\rrT@9˜r021	ȇ*qBe4/DR*DYN70EEF?Oחr1UxF{*M?1'TL	rI_%+"Nxt>eJM8~EVcQTڼ	R|ɘ#aVELlbm-a&`z0u<d)QgR!&;;cIQ4}7اuOȚۡU{sU'TgU,GF-upHEJ8$QyǥG2@!@Z*ݪ4V@drSuMqEg19nH"Nx;7=W:=.Nd,px?9r]ӧїCYĹ38-Nh#6յ<B<&o.S҆GfqaQy.P§qBS̔K2,,=t+\J8TIE$ҝeɇX,ŧyk(=R,-hE[ :@۾x^he'ϭ?vZjۙشt
]R,uT.ɥ.w](AVh
2MB`u	+26dƼ{޺>m%p<޻)y8ƙm#Z .a#Xn?=q %B3mjR}ufic*#DJ@ ޼	Z%3JR=^gS^0K0Us'HZ!e͝cF薼n$Z{9?ZIQHK`W1S0ZfO8X~x68]!^5|:مfeRM5-8Ijc3Fq#u	&`^\n2w9Rt=],Z.bv.,8(L}"	z`$=toaVf\Ы(ĵ-=C&p$eLI=7M-Nכq4Ӡ݃dezg9 Zp[Emlz:ۮO}aUPވlQ&:<xqFT}3dQ1MRQ^% 'p[U8F倢Z,y**Nhۂwp0i|X6޺Nsg+	>QX<H4Mɥ_o$yQ( li`#'aəU&q0(;Pz)fiSєJD):8AbF)»}vp!rq9y`cNIk}N[+}	Q]m^;%QyO1NSY{㬔Ma%iu5L3LM x-fJbPt.pB1J>f\P垘h*^ߌ_n36CDz~[5+v,f8CSG4GJK0UTH9AB6vbw^x,VA;dTe@ttrq}loc"_4qU^7:[,upoRNmtt%Dm.l
'%4)9ոhMIʹԥ8aKO-t#jD\8x^}leߕvaX;"cY][Dk]	L=[:("/\pPA1$0:	4affjBL Υm滧~=s7 z|@0
Ay7sfN?`"BX-}Sg JZDhB8ZbYO
Q(]XDީesxqi&<?EvnݚEWQC%3!4
+o|R'=FH#AHCc.afс@LE:y.'Ed
	JgnWT@t2|\v)fRSnupԺslmι41V>f$V]Kz*l/!q"LRF[r
udݺc+s7f(xP)+]1po+^/I+G՞2ul^
위唦ZCƩ5	-͗Y7Lv@J:Le
Y쿛T	xzcԑf>@-56NpGg?iJlN6uIٕ&ƐkP!5!w_IaЁ/ /y?*pn8KiFI.
r<X1	04u##	y'#'TL?RSNW%~C OLM78@R6ЍѷJ *{m:-go3<u'/R'b'hAzBqb
tB-}1	t2$7tBq,h]p;Cj_T=Dcfn#kx6CʜGy&hً+Fsa,(X%ˬc\h/.r-O<=r0m#8fc'oRʸ'"=U=V^.m$;ȕџ QE8c\Jv㞸?nkʆl$ec$U:Udeׯ-WHU}?z(cx;I}gʔ7	.-Qʮ@V0-zܿOe҂5l$MidJgQS*LR;kj,UE뭾F>̋'_)H/S7G¦><3ZV9n/Gψ;nd9LXQYm+zk5qu]&gw>5)cпu)Db-|8|/,#sd(c7xSGwz<DӅx^{LSW "
!E|Pt1@;HlC-^)t9f)c3SGԘMݜt,sf7烉1`Ptss{H<͗cww|8.zӹzH'?w _y GG_V"?ԃ(E+^5KWޖ҆YO(?Ws,JXRjX| r%^檺_1'S׀|QS-x]33ݺ?]ʇ6&*QV$HP$˝\3a	y,P46
88&ͩirJAaveD$/yK7c&ǭ;Zexp$寑lAe*2ME'nr4o
r'Pj-_n[`mFVpZ`[:Ft']H.X?tT56opbʢG٨
K?fkLI,R,SIP(PnMMWQҲ)'?U,io̱L^t+Pk䳠!Å"XH/xI77i난, ȑ6L$Lk+|2U;,4,w_7c\Ў GGp1
.Ax_N2M>*Pi;KXQHG[:;:B9͌+Ĵ䔼RKGqЀԑ·GM$5wf%:r:g8Q`^b.HR<J>gG_<׻,FtCeq"yptj:(`őװ`P{j^rgOԗ$LUď׻Π<w'u9qYlPW4ԛ3Iσ.2b xYebY؅)}Mo҆@z!`I-"czS+WYys. Gp>!|`1夁zIpzmSQZ3]e	+@6vS0w&m>z}*6{-//=yHkzNQራđ01j/EK 牊6N)uly/=L_RjM%~`ϡtTp4T,2+T.NgڅTFnLc<|@RMtB:>j=(:@Ie^U8Ej󵦣h)㽞,R<^3/:(OG_@kk(6,}4[keJ+M͇O8Cm(	:1cidg;CkzmF:»3H:J&*kO>H7.cic:B#R,*ǒ\~Xj!nIA'XD%)uD{KP(@]; [Kx^lemt((,@ E7ֱһuX(23K4P¢a2pр8E"BSd&N޽{Og^rmg﵎W&P.N*F` WMâ||gsZ't@)m1^~AtPݒoK~DW?ֽ51@R[9憯XP.Ao1K-ʵjL!LL#PC>o"P>u(K@{$@s{MHgZ:^`V[J	bh^ں{ءi8utG|?âD k6vj

	tvFhC9X 8%;%zImR˵qBWoRO&AZ=*sxZ'ݥkK|k$ݞJVˇ	t,
q,;G2Xv?q&fSmKq=5ތO8 ~AN@iT!{ZůHHِ7	OC@+	U*bbN]IR[Cc(yƮ(RQ'~&qBH (Np	k(~*ƏwbDnX;Ց8[{.d2v9eedkP+#yv]
dVEX_576NؕjS8J78(F"C5<>QQh2|VO6'chv֎D v-֪qCCle ZKY=Pʱ԰6)\ї:'=nO#_}HId:t'KZ^rFcY
a'g++1	a2(tV -uJ5~gTc[WRa3JKdQR;r|N5c˝@i$J@<Pk'H	=UY,҃?Ȳ%uq*4<T+굑־T	nlfYzLt28atZOݍ?!2r2m&'N(F$yIyN}6ShLNsyo>5VɛL:it;keNkGVY۽{/Ɋry-G:R,W#K'qx^kLW 3
˖P-ܲ-ըZ$ڔ +3hBJ M6jFFIHXk6QJνsoM6',s3^;+VA{A>"h
"G^`mcCzF*n^@*k9[MP7S$17T*Y¤y##GдJ<X:l=\O5TcPk8YgNߟox'Y3̷+.zt1J75lQ1*i,DJ8wP<)"8GJ;7/6HMB46@X&9.2+)@	(#nU VbE?UTo7sș@[uF,U`ԩ>5]fYB$!Ԯߑ+C8fV l8B$(d)*4hĠ+C_"qSz5ud(30Z)#TժGk$Tu:1wBuzo^8\zK"E(i}rԷgnZR4],(C8 ֡E fk-U@$LQDYt}cZGhʹ*7Zk%r;e0Cc7D ;P_Өd Sn,E/5NxztbPzIY3<
+;D ;l250is20%{vi4)V;1DMMg$΄+*㡅]JH$*.rݐagމ(PڎZ	{TtMfJ
k2!8d^M(&@h٤-"N,>FRLRGx(&~U[((gh!(χ-v%Y)>	pG'0B6*Og#*4y,糮XY'NvQcRnAWYS!>JwC	9V(un=A8.E\%@UndEμtzμb9nHcVr$TgKGV]L;rquz8s_SldNȕ\s:f##{JڳＴ~<wш_OA"6ibx^}Pe g99ND(?0<0'K<a`DHa=ټv?H>t*`rIqLGc2Lpirr}o߄qgny~~, c! 9ss6ZCz3d) FC̞wfO|3Oi`u]D6ۖ7X,}36Y!.Y<`qmHd9myҼ"-FCS4Cu0W[%fq_K`9|{8w躭~M=R:+)P@(26pQAY!s1-!1[F`PؽmlhZUnmX}q7v?CxXW)z`lG%l<b,x4MX%Qd@=WqP5߂Ȉ~Ia,dk5G[:!5o -l|v ˡgj{D7jH/e!]/"'urI	 ^M$S'w]%s9#zJȂ)Pkga]{!Gjrh`](3bGY2,n-Һ"tYm3\On'epa-RSKXCoWSUU"k
db7p[Iݯ!iOT]V'	OÑ4RGpђ/u%z4M%qb=J*3,`-uN;kC.Pi\;9}1.jNgH]ҎBF_f
W8׬gҤ&8»%Wr519XO*)#<@̘S*adHIQ(F^$DPH#tCSMNʊNr0&C#n7dOCTa-eoB*hM݈
_Wʢ-{=*nDT$	<Vij&`@7 c.'ˡv D7o38%ɯtotCz5>n	8jZ@v=q2ЎoEɘKǓ8'3{aFWP+[x<	+(.r>x/\ Zw4#D$KZ*X\^T6}ᬲRg^<23Mz0TU)ZS%ţ+Z	$ㆲ7MN<)>,[Ŏg: !~ĆПt/S5s/E7قLRG΢7l
9}= (u,x^{lE o+*l
F{>JHC
vQZ@		)+4
!CDȣҦj%m)-ܙۡ&|f:ٟ-F3N0)n~>藽+T}$-bݥ<dT-*˩T¤a$3P+{LB8/*t$[m?	s4~VL`chMµ]ꯤ@DG``*OJ춝}'cA<dŨA~͊#íuyaI3ǜRH^5M;qܠsBKr'fyǿ;-'^O>P3Eıd-N=I>
΍鯕$C7R\Ӷ;Вŵ] Fe\ 7.磉KTJ$aWg2de{,E祓8BV
߳QRѨ4UdakY>#,>Ĺcw"\u.TiaQVtZNSaD޲0lݞx㐹1VB7o{c9ARŻ9eL"#䶣I? s9O7.7]8¤v@
~0vDѧ#L9lɳyQN,T(G(҈'"gdJ0-	
]@Sa.l_\N ULbEg,Q\21V6qGjEbI	l}wҧFgz^Aݩ!TD9:ۯՒynwi"6Dq5R7g%bX4$w/Wd'dG,*"Y54s"1v/R#zT7[>rExc֦&z-UCQҌt)WV#taF'clXrH$В[q<J!DƤhba!?L GB0|rYP%-.ͮW4 E%	{=|#eER&y'IfK[׹LH*}޶na)#
Ak~RĎ٭IMK_iקfײ1xcqr݉|U{j𲩛{B	) G8}43b:qUS;4&bdzӾ<"j!Y'F\TsC#o03$(lw&g5}l G;ss}kx}RxVx^}Pe g;Ḏ4iF<T6c]8($3$R'lLC?jNi4bH}Wywfgf~ۭ͓g8s7V{3|ܥ1ϻTvøD]vO p'֍Y7CNZGr22GqNՃ)kN7wMog(9hX(#(8-B`D:dU>PWbWĳ@&^wYrޚKW_[g.clOBۦ GrhȦzϝCI zxI(W-_vU_hɡCzI&BNUUf"b*lSP[$"5&uPS]r'rT -mMLrk,|-X8VXz飞?,8B:?#Ȝ,cAL )"{]2ޡ!P7wh(n2B"I	t;D*KGr,	TO*1KRPa:B?Ŝ=;7B0kkƢt0ebP\T(kd&3TwOB&%%1-#+u^|A/B<Pt3<\34A]|1TpS3K^I+^w^|F0}i7HeǨ0,e'RSVߊJɡq,	:"n*8LG#<9x>8
O<#IqhkWPe:¬0	fY y]TtF=dTI7dIā܅iLI=.ˁOo<w(<W*~<AnrNeP49J]FE2!{C7٨S?Ko7geQ$qa^u;!"\N-fNQOl9(Cp ʙwsFJz;|pxӡwq5hH44z[&H;Wy[Pl䆋&:4}\ewH}LÒ-[%HbhĪ_p_6	nSan0Y&(-ͱ`:u^Tzm_k	
@((:˫
޻d2o\Ю"9oU*(*Zlã)i[*Lܦz'ƟvT$eTgaf%M\@STSA>
s)(:jyd]xq^%w2@#mptoS<6'q>?.ҧP]:0't'I,CED:|)2-taĂP##[diAf{&9MtN/=C)9[;õtjO*(ErFmI*k:9Yx^kLW 3XT(VBӈe"XE݁]tg4>_ Ҵ5bZ
lc44MCiܻsi($C̝ImzSR,?۪
,1K]viF2]	y>S,mN=$~4	̛HW4ptl(S'z5z6
:%2]dU`9
ncpl)4 #k:kN{dc9ʂGG(XnrZA/<{xk1d$DIꎐ:iX޶k!WFN\Vx<CnZGǺid9ًV"'=:Rg+;t<#T!_ٰҹ<E,*lNT-"uqgnv=^nEtVDʕKe. e(|Q\w\Cpَ&1fǐǌGԥl&aiÕ<(Dz|^H,u΁9q#|݋0[l&,lET,f$8E:.2W*jx&6YyQ.R#)UF9Ŭvٽڳr8Wz+xT%䑢-*^j|93=Ә=_W|$Ч-K4&пtSNT[YݏݜbdR-e+zBZ [?_Cl?2oX(̲r*ѩۤaCeF1+g(k$# enQ8¢ '@Ӡ,"0,RG|pwC[~e30ZO}G8~YDlq%J*DtK5UC}=@PT`g)"eA*PCHxp<_^1"Y|PM{ײ%pFENЦcqA]:Q>DWG8+uxmU<1lI).04瘖VNsҏؓI]a;SZSB[I];;Ƹ^ yvtFL#equEF;&ZmT-ğVD*~yw{qC:S8xH!Jc G{-O<5 mJl_ϖHXr++EvPNagH3#TqHE%}ϟid9l@\P%LxMŔ2NH28¡4׬ᑴ-Q҆>M؉I_v@eK4Ӂ.cW.oqrx^}LUeAw CLҋE.Vf&
ċL0#89{f\E̢7i˴Hݢ3\t{Rk)kmg;0}{sazzŁ~Y!,*j::@#?Őw]/~O_!߹Tk]LHguI]prckؠUueNOE`@s'Ia0,>pw)!xax-携8>BNI8aWtH>tK	IcdETݵnK3O<]ř_씭7k-8vyL'sȉ|)V-~!;p<P;jkin)ԥITzs!نO8a,)IKzs!*jS"󝔺l+֒8a%npx JIk3o&S08K:cNQ I
ㄶh:,-Aޒ r9eW9ԪZ'$1$PX!M-{8Aٿ,R"%ҽj e4o=ag>CksFuJp,VW֗{$A}3q픫yҪks&Oԟ_ދpa[#5HJ^x)Iߏ*ݞGאh[̀&rWJ4zwE)Hu^|:o8?Z78awc,(*ӭXx	p&,ũ߯a3,*JN<н0Nh71ȅeImNN0Sq	3+Rhb'N3
˹!UY+̅!q	d+vi2eVkIY;ȝ1Q/iʰ;]Cquܐ5)iMvJ̆͑Y`kF8oCx*.r9|`8Q=ȱ8N8v1آ~"-)4ki,@DY16eOg
DΑ
`h^%#q{PMBw*\1;SM,Z%H;R~VDO63KlwYts*	ed;0ȝlR93w><=ֺW06hw<;:R4'N7&&]: 93)vV	;fIP"ɼqs^YL=͡ Ȥvwyx^lu_qе9WGp.meN6&{y2	!fAE02PAh1$@F3|e	ɼ_-gri@ xܼ	aD/{M?~	3?߫^p-Ʌ7 &P&/H5jbrZ
rw\&Ze1b ?!;*П:\&LyO2Λ!Ex2M8NTQw&I
#FN4
7 8ê9Wd+ӄ52҃Dxj<@.?M8lfM9Ux+1O_ix٫>Ah"7/DD.>(ЋϞ	I
v`f:ZVۯO?,׽3T188ɩ.>SLфrmFmVB)\ZeZ)Td<RY!Gڈ	1h59@x(T}rq.աt=JґznGhF}M!GIv8)t0mŔd;ˡ
Eʤi3T Qo"("6&X}zw/i6~7'.i{+$m#_Rsu(r+OkOIzF*7b!BX5jPBh3ҴѼqSFa`)G`Dzc8P(k:qaS#XiNR\,S`ee$U([P 1ÞuGJ0 z:GKX$ECfH\.K&LEtOySɥi.JC/1Ra.uKkri1ɋH:IySktQ}eiB2{0I BՓB;ӄA
=tCʷ2zP$	#Am?z
t9K\&pόI.97Ju΍`MJtjELۮPYX\&/K1͢Co4N~ZhfQtGU:To&Īh+w0 xuf܄x^LgE@.NC@HЀ$?B%Hk{zw]K6ܖϖ412b8f,q11Yf27ѸAH fw>@x/ii3tY@l"v?*7/l=vWNUVod?8Z(񵥷IW?yJrG#:6UNdD?\>gڪx5 %1tE>6MzeP$[C:	̨.US*qBiC!I\"È)٬zeX"kPBErLzKR'㖜:R^=PtV$tx=/Y`Ato?I䗅A}iPnB|PG)Dyx$Leb!Fd.:ŝ%lܕiBh`"~:5WxI`"ͧ*=U9QQE":^ƕwPqeХe	\*Zw0 r2HsҰ*Is`]GXɛ~F	E`@e;Hasv`xbȦ18#W8!p>	y:k;8aG[HӍ!$Le'vf(Fyd vx{x9Nw>yi+zfdӻ8rG4:ȩAh\nS<p}ܐo92O9{pq#<p1,3,ℿn=Ά[w8YʌjLZT^'<^noQfB1Iv	-<-'WtR#'R醴R2NMnv>DTlnr	ٸh$50aO<PX,aEcn2G;y'IV
'ㆪ'8I;1]0z)ㄽ))48fQBr	9
/_vq~PޓV'Ksx1@,
6R'v?4Y(~9KmU9b[OF(Ww@iw蚹S8g	D^UtYmSG7pB/)_L#P{f[Zj5r0Nx7m_ضRX%S>05ܙ8fy	pe|m;pr@اs4_MrQx^LGwpD**
b́GND"`Ji5e[ar`j5kՊQjM6bcj_@KXjk*hs;w(qn7/|?f߼}t`gud[|wG6wc c:=ͭ@G0+zEsEltt'Ԕ vF9[ml|~U5<t,Я&]
˺ XcNww1qVTI43J@'ndL[[/M2Y@)4E%'J&ϩ+`O;W5ߡPs3Ył[-iO}Kgx.45.Ji_̱:jy#/TQ\E}L>Ts_#Z!J%`b8A eS)4e\>KUK"?Jťi)gdїsԩ/ T%ĂI01|bpvB,ͱKcělF 2h6^jRV5,;̙KIpˆ''@xUDW0jsuD󫑻oE(|#dHJ:eM+ZXt֜,+>eKzHh)Yya[qlLk<>ζ*˻q۴'Q4[;x%I{.R8ZHrDMq{nF*|s,䴒<gAQYlԘh, Q8|qH'L^69V=p.>I<̎Lyǯf6p2t}#SO:qFӬu}d}tDb1Ʃj8<w-gZB!yZU#sM w^ZnV.7*X8FFjV60O@-ߜ
4(xO䂲A1YveBz,rG}J42U|ޝ50>*gdh;Gl}ؖVFg~`ȸ2U-X-woU煯ô?ek>nF宵P3TzEb7jҙ!J1jrX,WGmێ6Db؃~g5P@* zwm(1dfTZd鬙Kn!ۛ_p!LO26
48Lʘt,ҰWS^4ФL9%@qiiIҏ}@#t#Ab	:U9-ރ͚.m۵(<Iww&ؘtcwۼ yMI䧘[V/*Nj׻ѓn
E4I>?wrXx^Lu$W:r#DY@ p3y;66!ʵQ&?+2eR

'V0FXz7m_ne}<,{V$Zڸ0~݀/Ch8,<RP
):'0NhP$*DJ6ΛӤ*N؃dk VEɱ#{FlWx8t1_77b.hùEQ]DL H~Utj6"HM=]5(?#Ԕosl"mԽ1v=k
9ᮑTgJl2ǗQ;ccRa.)Nc=:Oк9lSh|21V"I풲͆}גٌբK1k~#>8Ni	=1CգnE*cqN*rv!0Oj'֥ML5'T	U|?GUPݢ.{01	o6'-z\JWeNp/dY*~o{)հ0CEB
vD"Vݠ\0=Ȣ1PHZ=ᧂqrNpԍ%(6'C~
ΧJ8ap(4zf/;Tt1Du['a')OS݆'IU">bo#%<c&^?'fe)_ҕS%l3WtUwDZsIskWu/tadℤ2"=ˤϵf/j/y$Rv9=7zEp"<2̉	<w(iz&	Sfh6ߌQtߥ;@0{J|ԮҞR߉/֐8a_Y\fPJC?-Y,濅p}4`q?ܥU8mhmwha0zvdsAbR'<zI١wRhzK.NJHa5Q	lvTЅ'bXW4Mj6I=t޲ ')shΩE}.<~>1%ûr,}	{qG%_r6^3qIebxںG2AJ
2g&uqaDkQ2kx^he'itIl캸Vj$kJAȚcI-˲H$K]Tp:ae"mDnLatFǺ"C@Vl(K/|x_~{CF~*ǩh"߂v8?{@℣Ekl1x!1B㄁"B~4̭l=)\OC5,J~nN~w#)F֍<OΉ"`q^PhJO',6&iNLt'biG$_TIold))Hy\F;IeI/?7#iYT*E3:R',vOn`szx!M;(<s{]	k!G75Ӫ3N.x
Un"qzU.=kLVeN	5lAF71#qDszx.f`#-.G=R"_uvYIQZmkBrES|,Η)흷375gMq3jY${B]2b4mObw[-tWk	۩_VBR3ტ*cawqqڪ:CZ	y|YtX4
4}n" ͣ6HF*	=a]
`8!էnZ	!PCm>Ȥ@/ҖkKhW6AR	6!UL0ٍrsYWW*Ppw"} /;ZÍ26bGHvh?4 %s^JnoEYY*4cEZtf(Ҧ"l(*C%xg)Eu%iޘb<,'dxz֩qz+	Ӌxgv"Ҫ5%gaGΝ68&H􅓉TFZt`ZR'XːvY$,Ea:Gշ}#ㄭ97|&Iq2GTE
Hw8K_a@LoaˏKFfǒN׻M
:OOV+ңO8a?;\w'WԲ>]BW3c Kzgڏ&1S~/i^̠_ݲ}'mp9bZ,zx^lSUǿGJY 5`-lL2+f0emn1
Ӏj$1@&J
0$SH$ 4c<{Nesnn{;;@3D!Ov][s,nft?M^!?RnPpՇ.1@]%	QDQNEu:5V)yW	6$,17lKSIʈ3VDimõ B@@|oN|9p
]_'4PR;~q+LMS&D'h@EuXc#Фt7h!e,)gXN>HaFiB=^bUf
B0.27V8|*Cx4G1\\jNՕX?(U6xyu:j+K-vL
j4*).Yb/_YaYkr:qC2t%p]wrup[s[CH^>JbS>թhw>Y?oS{i{ͭԴqz=g#"yQɈ|j4d;;1eVt3,}7bp:?d*U`tP"Uρ>BRXBdWfkLY`G[Б@jFy4h(OJPJNV(7+~I҃G
Idn^TSE7_ǜUZ8dE<ɮFW(Yw?qoRlgx{_т#W9kf+ދgCd_qaJRPz$X~]mWPr)HVA[9cI(xBz sHGV<4Pxb-9HRIڂBc+ʓ~	Z@zpy$o$yhg'D];Xh?yٶZi|:6=8c+8vM4-(f~p!
p¥,ZHv6ڮK+yCϭh0ezxز]LsIfmZQzrTTuј5`q6Zk!7]5UVIɔo}v'%N>	rqBN.lnD8W&L$_يE/>l1*vo=bǱ5_`9+9/N^wFia)TFgѲx
ѱ#ʽ&
?"yjbG/(';L9=+4bPFCG@(bj8/qgB
fښcjt(b5G@\=@/_S@0ݼl	kf*x^{lEݣ)
Ң$Dc+5w$9@hza=>Dh? ֤ڤ*)QSDBb*-Ƅ6jFRwv&o|nf;]#DQ&EŠ`<C'Lp%]¨gz8OM@B*l=Tc[Y׎1Sq1|<%gI8>b)qkR!7sMaњC4n&KIE46MHBl)ېrJĢ_a=\ĊchSM~܄#D	4z{	N#8n&~\
'TBiUn܄AP,	J7oaOV#(ǻ$>)	}F&,z&-qS!t9+	vG'ܡph
T
B!`M/N~_}pU#%egʽF)FIP{igS+C 	Wûwz.NquA6%V9)Yߛf^$cT5VǓ cM4rm_{ߠՎk1d/G,f>oEiĀA<]&gAJ0ް$cpQ*k
lfdcE9(bStn=A.>1d=:GiS5SGˑ.܏Udb:t{CeӦ[**{ZUt6QMo!4F`:רd8[c@-_,rD͔e"wL$cuPoTw-Jl-gk59gU|u&ςN]ZROVԖg,asjm;ή\2fV
zڐ)פ9uf3^mUSS$ ]ZT0[hmO'U2/5ᵫ[*[*NHD!F(8Lnhؾamc&畏z4fNVG@3m9ؖtB$e2=PT)Ž\i}voы9Ip&^Tdq7aIp66X6Dc86ZMX}}
#dks|[E2fu:	GbfÌ*xp:AJrkGP:KI_~P$	$^Tz@&OGΒxʓ9֡{
sbAOd>O-qmBs?Юx^klU3mmv[	WmX-.icp>֨Dh-i`>R&IT&ƘHm@L$Jj\=M&l9=瞝u@^RЪ/+!^K	{ջz<~}mi˙ej T1쉆5cퟐx>ӻ}#S3G^)L`^
ޟa@GǗ\p,wKD%gp߆**jA8!9Fb-/+>IOs)Z'cpgr),Q]R>e	k.X^w,o_`}w&Uh10yGE$`C-8&V=8&i/22'8/D>/5%Y!svq۝4NYPO%}BR&3Z(.2j*UDisFG>}<P:! 7tnt-c(M8u=Wa@{:VL_X;Ȓ1P:6|9t?)̪MXr>MZ "}:qKwmaItp(ZX?LoV	a$՞"HɂqˡZ'㤐"0CƄ"	|sJZ'T۶#?L
Xb8k&ٺ7ŒC]_MBN:\l)5	vd65;;}pVV6=|:j	]M2@q*!9SrNZwON$@d}cZ'_t^}ϴ뛨jbS_
<Dns{"Jtq£$tL`UeEӏJ9vKgY8~$֕,"eB$p2jwA]nH)$Lt2Ő*ㄗk#nN?;v|-;W̾>Nؕ:V6K:@ܵ(Npc*	!&hGh'`h鉦"9Aʜ^0Sl籓9SQǟjT26U[JC1n	7DnOp[EN#2{Θ
hYcundzx^le];Xd[	#hN7H[~,k^k-1.q	BR&aD4[0:	1Y0c4l}N'־Mot'
 [5O^&GHb<P#}s'M[h)W}3Bg*RI9O:dz|%+L(rH I'bit>7䉷ZX]p:͊rSgʥNH)tf~jeuiDS{FA$bV&ܦݬYhh4]	L926YoVE]?*̽[8b3f#0MA`T*xJJ҄#:&G}J/̍	KFSn##vQCȾ׳4ddx[+YUPq(wϣX RDY-ӝ.M6IfϾuXkϳGiu*ӄ4#	L؋΅ξI29k0h,НG+.M8q0PnpE[:FGW~aT$BZ)<Ɯ{w~Ov'٦nPTʐٹ][>|U?ՅRqFՋyGRN2e}XY0/rD19v<mh	qH YQ%%Ψ\.M:Ӌxȉ`$v}84arUrQC{*=dnnvKӱ9I:fycH3K\ת {h8Qcu_9O1uZ95J蘷dg4<ӪO|Lġwsv!MPwcpQ5jG;a4aٛ~$HtNS;	Y28c!7W[h3.aӄYN3;_qҡp_^9фKZy2H4
%TƢHUԎЄЯ)n)Jb,?4[m]҄>8VPoN]&j+vB?,UNʄx^}he_җI5-նvRNJV[b-stՆKz;.IE'IT`ecSpB0QEmΡl䇁r>y{^u+qAb1]W#@pU=]9ƽm=^1!&RIt8P)NIR2D 0[_T	X*:~OzL:ĈJ&=кT<3M*jϒA:(n5[U_ƬHmpo0{8)m 	D(0ZCJeQE}㬓r"Q]LbRR'bだjQ^M2NҖm<QV8WAmhOFWy@Q`LMΤ:R'xL9&Rts0XP_Z'ceo5޲1kIe`iyD$}n-E4gŐ+L*%i2ed*	cƹvqՈ^:jR'8!:xk1H5gׂfhpyZ暱%E87c{IYDp	]]Y*bNmfnR'v<ycGbD07`K2Nx
֝HnC'ҹc.#Gx 3	mP v# 5H%x0꧝S4NEP?Q#MRt"NЍ}Jp@Aަ0+zZK=by`-ZP-qo!}PI&kzyW7vÜuֺN+^,y<8=&$mf}/Nw|rW}q$𰹨XA~,gsI%ְ+h;8aoC]I՜BGx.mFjyܖ]IMwL\JFǮд:;nԭ\Kd.Z]:9qלLR0<XWA8>,agB\ߎޙA}8g<4EՃ]'|%gy2Kɒ8Zr.<i=÷3#9͵8M!.8,w (o
Qj}e}mu'~Z GG])$GFpg	h?U>x^hW_4kVZAegGm;:F̭&.WKMwI%MN`Aalce8M#u"nn&UPܽww5U!}޻ѣɗ\şm{_|xv7?\a ]}	EqRw7=c8KWD-Z¸@rFT:Re%+ڽ~D=rB8%zR
*LՃ;Hg\!9f6/%mu'i:.GH_\vSݳؘp7;Og¬!w/-]Ic`P_HZ
/D@4Г}8ҶBH`JI.|)_d@00'^1`˾~6GrrKC6kX)гP6RYY
QO*[MYzGWwCSh
:kKǋXc~sINajZ񀗅xLMК_R.(Zym9XY*},&h8Ża-ouX9?g҃yUDV],-Ew#n|sX Bj-e3Lty5JՇщ:Hir<y}騘hi$5*q|78O)(9oh[\8ʳe>c\U5(#/l!qٜUN{:=ث['NxμUv7fNB	g+prBLO,![eϓnHwed\Z?naH++?a\%QIu*u\_G3
+qژr4R U>I:
>KBؓ)ZSWpH=?RTt8ɤh6vy5\WS<Zէ6f>FW}Ҿ¹B6/xr23yk߯I:
EM?Ub>x^mlEg[h
mbQJ},RQk!vׅoګ1%T%1DH4Mh01(HƐhL/B*b@"N=d\6gvfv`: <=k5$~@~LU]c2ߠT^4qE	k,%SoY'؆=cP;eW8^̰*c-o#T[jد"S\ܻi%'\-Ih=⁈lnQP5v8^IE=[xxͨWBV4Hn8?ͽzEvP,gzz\`mFJy*)~)>Ru^\0p0rf.FzI<P5m!{l:lk"r_p?MyEA]&3]hrSclh:g]'0:)x{x{:T׹joڱG0|9kl>H(20qH8|?[<R&TG-]Ե6%Xp-ݭ{F6ֆ;HKn|8G0QMRW6w'B{z
"Kaat	} ^@H,rn")R{GZr򩦯S|K#OI|\/W*9~Yȝ<B%'VOzT@;p!mϑ꾟&k]Γ0m.$VPl\/ޭw'QInq.6Tk,p%}6A`mhR%<SvJƠ̊W ֆf=bd*G$1i%;I8R|>YT]iP)=8=Y0͕بᄋ
&x H1I	肮:ZMℛr',*⏩S<I3'l/ZnB#ܤl-θOW)N8\zss}23ZM%HZfgQu
2!jۇi6/;8B]!tTf/qeŽ\?/HjXH\wg%=c52xr] ޗ{6hγ<-ֲ+9.Yqи['~.uB&k~,$%؈җ^^M]ݺp>'L{cOo+&T1eہ<+N^ä&G90d|)N_cدp0ͷ;H8!CYZ 0e
{]htڊyM Ldx^mlSUP)d xpDg̙0vޕv+:] 3.048Ft2aŗeBl=|d4gsNo/]0|eܰ턷1hI6Z}nl Ԡl1,5qa%kW^38',P\rߙuh|.8PS!K)MڱQ?8JҮy

JD2ްM;hX3z}v4H6K8G$=T)HyDK)sugq.N\S|N}HM8
sN~QEkU}mȹ3dr:R9'TWu}STn54l6rՠ%\F͑Aq}pޝZqQFF/3*zCVy]ed\8a,tN5!ΐ	\N:W鎽.30܈bڑIR![xkϷ&q(
&尉/^/'\kDO 8|BP~{@V qѦLU'Yvs
'4*nVfݮMhj-ptNn!Pkkw2R'qqUHPSSIiph_'UQ J~ġ2N8̮<"yR#:à50NὮ7AT!x<esR9	OQO?d!KbT4] 8!<G_
J;CZ*8p$	_π=+HU+rbR"pѦ(46]pfK@zBﰳD>N=|Wz)#W^V;uq n2.F@wZO|Jo|/A6²O:}}TrNJ!<Bw%d%*eՃݨ'π跑)R!UJ^񻘲qokyD@荄tIܒN*ㄉHmz$U{Fd&5kcltk1i;a/NҪgHVbPV(6ꐻ=0NP"dj#Lμn/'eqB,qvNU?K;J	Pn(z )M)8]?lnix^L[UӎAm;E` naC`?Y
R,A+m4s,"Q- 81f(R?8F\Bd1Y\8Io^ҜO}{[鏍,Z:Uenv7n 	_<P)2ȩ짛YeZ&ejwuŻEH1t%lU	nǥ}j,J,S(YA	W~ʳ8&SHm_xJׯMwae0H%k'E,HHvs$`+.bEi2^axsDa5UJύA/#2ç4<LLu f4
9z9ui:lv<C\ɦNFSiU':k\D/r~'RKsZI`f_N=w
IPgSxD̉ԦGܕհ@7Ƀ.alq,}ikuT:].Cm M~.o@>Zc_s{)[u­m
Ymp2םikp5)RmhO.$vسyHiP\R#>lʸSsXi/z.	YYOnG5utƥy̋'@맭kuRMiW%-`2KaeJE:=|MzCݬϓWK&]G!Q)wGa(hlKR4l7pi?2M%Mƞ%RYRÁh{:K헷Xe0F%ۍbGT+Jmu0jop*ǌ&+B[	ؐKo$s4A$YSb)ěu!i-=.WCS_Vb(/<nӄ9"̬3I^SU&ejU	$oܑ#ٜZZw]PPSݗ'	趾qIqL\~*[>D<QNWDZ=( .UX2MȡB-.+}ĥ>ڏ3'W9EPU??ej"P@KZ;·_g$x^le]DƘcM22qSgʺ9LWvkwYۻn1ØhD"'!$$n8DbHTo{Lk?MTp%)`3;~%+03>A*	 ܴ.N(Nҁ,g
z>w'q(Y>,R**sd,pƹR'z5vJca"!UhK4:V^`x]#9B!΄
>H
;piʹE:>`HCbᄴ)E>fDT̹)6J&k_oqB,;OmB>b!)l/"(VG~^ytR'	Aru6Sb0O/"qurF"/I8ų8V*)|f=Ha`rvKE?P%61M	XϱI!o6Smަu٤2NxIIێXPDA<g@_lw'XWX )>~?	+d驗9(^N~)-ޔF`O.᜗5O%">$ڱM;FPxx
/43e`H\-x8D.\7Hl%vt?俗u4#q"'VKT{(Z!qĩ@ājSMJ3_#uq9K<LKǃV}PτGн'Wq2R0Ӻ8.'Ӿı0iv9	}C*NX,`a ڪbˑ7t8*e]Z^}$5
՚<HOs(ca8jv;qZM^N]"̴g]r|ep)(PtkFvn茑{.о%LOj'#I)m>%ɆRܻ8ۉuujѷmEfn1_z)W":M	vxS4D_p^Qɪq,R7C08(`;#@DDQ$g~j8a':TN^!?zsOB^RdѣQ^{+q̂Q7)ÝYOO[Do0}S,s&ov#s<JyA1b׷g߅x^PTU X1B* n<2rrwwŜ #6L
jfn(cьXY9jsvIӝs߹翏1t6/zYM'%z笝 uCjl/睼lE133Č(RTӻVL9,c>WRI:UL3vfqN4俸!YrlF@W
ya-j×o L^UP10Wrb`
)w96^rNKErOEWL<gmmv[XJ?{6	"/YقnǾA̓/2qUwu?|.ӸyY&x'*q7]]{DVB[\2q{Ml$!ˬݥVh1}G_xѠ)הi.QU#`ka1n^&\!3`ÿ
E۪li*>`gBT--Etۦ^#iXe<49	a#e,2,M651\W"HeOm_W}j.bup/u֎\)k(|_Z^jA*$vkps}9C{Xಞ+ef>#{V	'JqJnY&e)biT7e>Y*m[tEu_gST!٪_un<ji _j0h)sLYYejiOFI[op8;#|ByΫP^;Q.G$w ݲTȼC&swux%1$ڼ<eU^C~P˚ߟJVFRP#Y ɼ;nMĹذ'+$Ў7\`sRiw|'UWo?Hq/`c,Va2ȋ`:;%CbKOid`ȶYNIPn'9m"1А՘e R׃ȪzT閊 VLo Xr
||
_Wv媐7/hB5,P(d-7']$M(u3jl`J?6b+4-ճE{.|X	4$FZ*^()Co#5me.Ҩ#1|<1A! ClfnD/,/Dr㩍j[Lj,&pMyq퟽{$za 9G<PyD'Cv\p.ûHehss$k)i#`B@g2e+Z羥SS?EgJOČQ)h(PA+!R1{FU@x^}LUe }$Ƈ놔|%B%\L]^$@0q3te[MʙBUشbn)dpCFYwn4mXcȠٌn*=>{ιLEӞe~&aP+~sO>	(wr/^| ą~Fho$3vC}L8Vͻ`
H繵)S$;?yW4^gp5cr 	WPČ!im(nLx\-cIA/?ÿo<7PtȪot %Z?cXvܕ}vd2B|%];(E:ɢFh$eޖ5;]42Ɛ+X,r6 Yj͓iLi9ϐ+PyJyo5r^.-Rhwj˅`vi~8墱"+:F;6^yPHzaM4^"TrJۼnAфy<^3.3RL?^X];-l+ēEDCK`彲ȻRQO CBw:YTZ7DReШq$vIRʍRH.'TL{yYKҩ@nj\Qv\ߛ,4\,m(x?W2Iձ&W&2{={Lj\!{bcD֩cwx0B<*:GPs=͂G@à;'Gywv+EdH<R:^%%WD=i>R4%5rT=BA\u3qsK`)&ΙCtS%ѧtADA<ۡM['>LapIHWMA.!-*v,qMʍ?3R1܁0g6ieZ҅᭳S(%|
c(%G_hhUXW[V͡t@E^E1TҒM4	\;^)5)LAl@bPwA679,%s@F`R^4TbT!,am6"jPUg̘Q{P_vh܂KHhqqșG#'=17)+AT%Cr-xŅ(mW5o8r*u !򭬶s_N]si]P8c9QQt ۦUԉ׫P&Qp#$cHMa"Apmw|b*Ի>mF8!Ʌx^lSUǿ;m7@xLeʘs:tYvx6DLyhDA$+dČLz9f$ͷ_鹿>QlIp?3hqڝU%}P.j7hn5e(C݃`g@/&aÍ 5&l:V5`g!˶@tP.8ﱄs!Q<ơֲ\]3W
IRoYΫHڝ'y
= :]1)ѣ+

L< 8%$4975峰pkmysSXLp燁<Dp8bgd'6m8~힑,*QZ"Q!kxYuYFß}NaKOJTC5.ĐGqm{?uH&P_tsR\##:
2폝7I̷8T+(c;#t8m]ȶoO&Z8׸$!{M$ۑmuti:l|I+x-u(*d	֠*HT)/4wz%>5QVjId][=bQMOK}=)ǥL?TO^}aOJJu\txe./]IH]U]rh_PdFSX?VsIj@yUR? }WڿBn|{<H=8}mܣ<m4v=
cXpiVa!\m4;ϧ}8@Xy&u!]4:bxPzQkKr!558~7ڔj&UI<d[isϱshỹz=/zhUA;S
j(fVXxUڭ&^tJ7?@llV;HTa-*,%%-'ΕػaRƢ,3L7}zP>g0Jg#f7甗Y2̪򢊢9aRK%T
w1̮<$"OAцz?FDaW=7!_X0d j	яI1HgCҁ =ѵd!˺F _sc{`PG&],[a/H?d(jۑ/[dOA{p(h?Yqb\: R=z똜Ա89l=0N0(=w~l,hܹ=U<M5fO6sL@dzoYayfT'
sNDKߩМ\*p1A4X،9q5\cCY2x^le m6p@]f!lUy<DHwkk1`b(Q$(a44|(0 x˗=@T)P)U!VGcRԴwi!G=20YG>pu+Y	yMqǉ[vZVi!965P hǊr_;֬Gbp@1C$(J\f0%7P΃kƑ0)]$yYtHBTA-elAw~]^aM%sW&PE^lkɽhq9-%$"AHѽ:Y%θ~^Hin4@ ?"Vc$.r5HWIlRy W864G?LIWHtT!Tp_J?h=TQ86,*ɋD9Klt(!˂Y (
N2<#dWQĥ}܇E2

kzi(w6G<A1꼛b87GytĐSK9˓n0f!A7@_0;$͵񍛰WSNP*
Kv(boYgHcr뙔4"f&5۵'-3$8[9&B/z"䔳q&JZk$:jm%L{P
V2e_7]~Ƒ~_IWਲRgA6y/>m50nȤgɋ(/=ڙq<cѝpHG'ZeXG44"&(T9=H2E))kD!dF~cg,Y=:1^4𪊪mWj:sQ^z!11Ƣ/K%ȇV}rPbzGY]y,!ߎ=JyTl)DU';iS	b2}fK̸)W6Pbzj6}E2[u+JI/!Gt|6\;vi~I'5Ҏl{bYU!#{XGGG੟IcA;YW[Np[4F#aMb#Tu+_ȏp_j}xQysƑ(x?'`a(ª%Q**F)ʄ9YaB{
y
>tkoxq~IV'[[$R|mv3ȋ[zI-ӨV2LGg**,MQS6VFՠY^0KяIB\=q1~ii\}U~Y?IVჺ9ɣӺT_H|RX=׷JHU7o(LW#/`#wx^}Le_eWJtCZk˄2^VW*qq=[k,1یoHlDC&C8Fa D۲{`}44O~wWl3zäo<L5lUOQOLS>Ŷoi88sbcL14\bg g3B2'̱l	ըmjzb`z''W{Pz^ᄁjQI_=m2PrauWB2&dr2PK_T80bdJMj{kG2Ѧℙdj Jpw+þ'j2y33+Q6@Q#48i7[xx0t;\|\S>%`5/K9HlUYܺ?;0\PNʪ*WS+޲{G&۱)s4P
U74"'wM's^zFcX|锋^2%@8'İ0`Ѥff2_Z\JIu[Mw
0C@NYۤHx(mb994	4tA-&Ql@ՙٝ8r#
#}q%AQ-Pcf3̊i1n)ab64k)/L8U4lFQfCrrc[	砛FŲYyBМj (%֓48!$+4ӣxS\מRGyₜV&U(M*ȄrbI&σe4P19r%Hb<z 	O3E#YSh8Ut g;=Sp5(C"!9]
$?w)7B#1uyjվK7Cd}KI++%m'H< %eߥ3J71b3_%	"ZhɄ%omRX.w0t	$n}&bq2i֔~+W[Ʉ k%9a&J {࿗ܰs﩮qCMC'ό({R>N\֗Ӑd:j=8O7ו#y4YuFJ̛_ߎ3L"?d\x^}LSW 
XmCAmH5snPf] QƆ!&lL]m4̍!*јL1%&s?l{:zJmrH9?=i.A_U.)s [8񉪴iUW..ó5,ܻ/d(3@h˟?SH3Z(\۸;HT5|tA
k֒9RLMw٨U` X^&>ĂwfHe^$,JSHB(-Rh)Ho-źھMUZQ[4׾jV!;U~Ɏ#Z_94j{ሓ	yr'bq0)o;G&GŞ[iV,4.yI"a	!RSPiDJ[=W	)4|u_t2dq<Π@S7d([o}FGPp.	Y.Gd+7o7~6lX|}oav$,
Zmfk	;gxhlC{S~sAjcݲ)o5*ti5)XV"E)ώ(:k-"ų#ih݂BSE|!E'A;tGD3EPɇ]<@ҷ$Dlr0*t!:6V8%㚯n|t́^cGF܈#'.C)%H8B[7:v!Oiba^VgN"Ab ܢiba?r2@*lvGl@HV= yqx+_("=`o@v(^gqyҷ$n1E´E$+"qhNu"i~J	*2zd!G[@|@]Hv/gTly
ޞBb+,vWeh'ʹ8B.ct,Fحr2Ӓ<@]{G͑肸	(!*ՂdPHЦ&$t{qQSn-P P+bh=%&dfZiqcȊYzJKCOG,XO]bN̨iZa 33fSb5E	{LbnfBl[*͉91lK`x^mL[exi"Cݐ
E'e)~Xio_kn&lqq3ɒM脅-1ܢKanzs̆gM<<wL[GAo-ЛlA|TWln6Wl#R~ф;݅Ӡufĺ4;\@E3):yNL><?Oڄ@)Ƥ5C;2MػVJ#eH|24ЋZ&y#_u8'Da7Xڲq*%_L=
pXp]Ȯ4uY&P=;vTB>/:)40vR&ڣm}81cڵOV,W*ӄ}d)3'9CRՇR$I{ae/qͶwjE=j0M$5)?۩ԉ{M8{LBKxx%/Bu>3	Jacy جgps4z?q69좣]O14ឣ<7dIBW	dyXL~R$J,J	!)t"='uR[TXJ	7A+vDӄoS.Hf9pKXK:DzV)uis2xr(<v-\.b]w,/k3᚛Μ*FJ7[\;%?0ʝ&;MxhDri<!Q@'Gu_!	Y.F{ @Dt!uJm)Rpw$Ԓ8]X<؃(%5ExP@F"B}P)L)У\ⶢBdb&2Sbŧ	KאŤϣCObnLIk~`]+O-;SCuLdT$B}1>u,\T(7L[Y]]{>.@J;gQx.ౌr9EvMeiZ+YR녒WB(5޸+ӄצ%boڷ=EЄҐ
LFCGuJU*xB%<7Jhk4{&J78Z#AM4Fm؂Zax^lSU/L&6Lju`csA[_u]A݈1!A?`&&2#$QCDbF0}8\f{zߛkK{U0Wo2hQ`|Z|-=Mvpb8a3cWz؏1p')k7}6WKjy4'|Z_cki/VKBЯDIF>[1[MJㄩg(FEL!'0H|C
s9}d.$PEY͔#-hR_KM\1\+uqC#m4V)TMJOnc9\E"IB[><|=NصHnGb{7vP( -&0T;œrB,Yv	{1T3?r@9`PQq	M*PduB&UT	Hrn1nZhU{7N''$tVDJ(IJㄶPjCWqp#0g;]s ]N>w$ip#wnTIki=P35g83IyX]jXcup>.	9<ͥ{0N؄WT 6*$3=wza5=p vcosS_+&s~1N`|WPBЗʹT	/"m/diTp_8t
|FBPC<@j$R"ߦqȪAJtrvV*ha[hM\3i·_3?G?uY9˭)QtrlzgP㳯Hd@=@y mIOdE}ƏNapkmӣDXգCo+'iqz)J0!$e(cR^4VF>Z˵.bFZ>0=F+|KOrascsGWAQép7UkIVutqRK
ND΍w;oZ\.Nh[LhC<ުO	%Lcj"iجa!`V.8yJ.Tq-R42ϧt},}C:YÄx^kLU 3lXM)ŀvP ԄEX[\vgi34FcԶ1!1)>blL56F+hՈҦhJtL=͆r9ws< hЋQ^<\'KO{/	#CtR2kQI!ҋT28!%Z

HzL A="<4%ܽ/r,}3[8Qo~EU]Mͭ]ݞ`+ԃ%qk+J,ݳJ)E˜)QRԔMe,j75:p9l;@.NbU!1)$Ն26DC^J$
;ޫ?40	bTo%"U>Odp4==4Qʫmͩwi̻K)[]jش[ϺWg59$yR؛xg1cpBY69ш_	1XL>o8d=/m<FwC֐ȶ' ӣH	흻pX'd%Sa1DX%Il1	Sܷԁl6CXTTk,
W3JXl񴴷CtE>F '<0</Yn4wv*SjQӧ8S[ƎQy+](Wwt~a^MQbeU	"~Piz*#Pl['TN/Pu7v&!y^85Snmd7T~.*<Ows0!e}tQeđE$a@䛀vh d2"Xܽ\!5١Өee<#x1ifMg]-,:FkO
Zoy++rHEygg8	Szc}h.~Hi|?ٻ	%wqPpo*]zpuFrCsWtJl'*1	h
*S<`A,GT39V(oIɲL'mF&_yES\JV/s,䮅s[XCe aI᭓Öλ^kT>B';z-!H1uJDYtmQ|(*Me1>|rr˺NfLuwH}Osi IDJKLAx^}LSW s2eu!dlEZѥHZƹui5ssE7mB45~nc|L6729{nG/q\h/YW/"6BxF)Wr,kCNcK~	{{OGO }- Øe0hkrAZpm.kUKUizW~+Sz]hrFNN|5tT`CK>qty^#GiqCpC2A0t[K:3N8k[W/_"ҚLU
l#WtPhX1jDCMr*F+X.@sXvHjM+XEFd&miT*Vo[4*֪CN䴼n&e/Y禩ʭ<=	#yM2f3r}
AOl~	Xd-~*Bk̉>ڋ¹ܒM%EGWL2j]>]$<{}(YZ~(ԋ5EXU;Ӡ9M|yGfs8-4¢ճ)&/ئHq!cdfe7	~A	XL!̀1M	4;ΒV&_NIgiG+)KC^ws
X,v։)c*mJ)3cUW
	w(V}=)~U}/
Yl\>,D(5d*A*luozwb$:^ RL&험

@Z՚ԎiG=-i.̹:jqb'B{dEߨM 0`B.?!(&ӂfڙnKyqzZ;B0o@ZՇn?f2Gfq=@!e#19?Fg>x>7n~*'P.4s'Tx4Hʊ۞V8Q뵭s۹=тdb=ih/]=Zgiv14{;e#exxW\96)tjԿ@er޶ꃵ݅dUi<ruh	f|͹*q$g4(qۜbtzsAn|$ 9jRGUj=,AudqQiEvd<i`&)S@uo]34@4!ɺTqSDh6gTy?0#iHʛYO
MsA:.!~Cf:/.BWοpFHˮ㑔gϿ]nЅx^lE }-XѠWk+D҇Zbhޣ];vR
$i(),bF-EB*Twv(%ɟl/?3{E-V!Ot?|D
<ʓqtGлA.$#	P,6P2;L')EXhpZ
Af*aҽ98-=B}̎۱,<n.9TOߥQ)I;`
Vd9$N>זbzF>#1,R.n)v4*}t(spH"o+E*Ojr	ҁd)nJjSm:"1$oa4ൊ^~|CTiqf1(,Z2p&I^^H%YgּrPS5)rmX$M:iC>4{$5tMS#-ԗ$,E޾hզDc˵kc #%mZ1\Hr\z8y2]@0(\*
ƨL7ů;	-z%tꮂR W>x&[F97`nkLu\Ӫ؆\ڴOHF"0Yo,A|HHjt/v2QʶuZĒYTJf̚.ڶ$	H,Zdjob-VlZj'<[Vz>N\zbX(-J.,j'P04=O m\PH\6-aFzu=_vUs$t.pp~3Ee0:pC/tf	"1MY_l<6EGn:?4	݊Dbΐ09GΰB:/w/{ntǆEbiFXOPT_]v-U|?p*ݶulϽH]]vR4)d"{yS[9sHbhH濶@\beD9moY4}]w2p愳AJ;H">a1P'O==BPjDϧl,;d=LNN
Z%Ke[(2TԛQ6!Ġ_8D)W2ǓO0M3QG̟n(Z\A#*A6o\1yʆl<OXm_Q1|)#CbAw<iX4[t=.V{JzU0apt܃
]סw}ާ]Ccbt~ndѲ@?Gbh=xZXUQJ_RM91z|Y#]&hմSVb|FV&Ύ?I(/=B	iYDcg6f1GpTndgCymx^oLe1ɘ9t2EA#:6-hB]۳;HɆSYa:Hnqlf2&%{/L3\?ؤ|=y܌ opg'$?B.-?[pASSym{nGI܌ZW0;LVzM-brޖ=K	Uÿ-:"߻Ѓt8NRN\s1'82'#GZTZ$c>?XH	1#I;x	t-äjzщ	XOKjFR\uH._!x1yn2,NSxLE]`8q+if~lRrj}ۅOAPMԦh֤ڑd`pmA嵓|}Jz,x %zva..
nͳ920NA4-8YCJng⦅$EEIwn/z0aҮsEpTڙ']IT2LW'DҺ_H"DBݬ$q8!m@ԫqeic36
B;
.u~HJwW&<r.6
1+|oÈЦZ,u>
InȤn:<Z402W1$<@$픑Y#	6߽ևT+,67ͽb~<԰j&b_T:9@zyyY=ÕnTR~8J+I]L'SGJo\1-\oO=C?89!E"n>4.ٷEJLb\-rMF	GV%m4X(԰Dkqpp7bΕh'`gCg|L~`7l~2*Nɾľaa7l%a!F3QqmFVakDQ%h5Mg}\m}2rACɖ0_,!F?dBP1FODoO	VR8rMAK+$	Z0mŚ`rR	J]CFHk⨊D"BqwoHAK=NCYSe/@Pb;	6Tejx^}LG ,@
-+Nө*ڷB)LL̲-5.~PjE.L42fŹc.w!M'O Lς
LVyݬVH'a*{N[!t}:p>#KPìď"$:{2
R3iO/:*JKm)}D7oh	5ZP)YiXTsU)ZHDYµ0L&fb\mKj#GPĩvW=5bZ b	g:Hqn4$ᱱ3N#/M!1:&şdg_u`Ŝ5T&xH/"WQ06u+تfu⽾(|e*cEzUTT::nĢ_Z؃w t['+BTMUkPiܣwrتK<#Ț"P8T8iv+czRqc$.qLlcHfR$,No)V8)SQ7N{>ZXr٩4Tb73!"xx)j(wRu+>;A7d7ċ8xEev6]@%~;.ƻﱭN\i+%Z&O 3	]ɂ>$S=y[ބe"
*n5lVjL
Үϙq}&`
0ge>e[x&EuQ~RAfq_Т;x/5h"C0lY
I?΍vmdvɋ^<~|ܷBqWrgʤM%}Xb9x]"Px ̣y1ePuԞ3,i2P}Kڡ1E__>s[H"L6h\!s/#sON l"/R>Vo0Jѧk25ǰ9[0	;|&8"$4bWރkZxQ"ǭE-aSm0Bk}ojX<;cjKI(9L:txCnNثQ#3\Ef<R㓏 {,څS_u%NZ0j2wۧrfηYDRXl<ֽ}t\;cE|.K@B#KAd*'$PM~Mur8WT}W9gCBJ~m'frpHTG&e@xD>Y>tx>x^mlEgv[ iBϣD^VZKw.w`E*	jD@#!U/_&b` h4D	ugndn͓I._gv٭gN
pgkHq@ȏ
KP oNo1\ ebg4'ֺV;a.M,p+Ԯ̤aipy\Mi4WO)Iɻ6+4'IRk&KMZo>⒦C]DBZ'{b>Uq0kOǍ|\c꾎 \0d"	3ֽJ
kt2ZHc>#aMinω(@J2Ei&hZ={f0wZy[bq>C 6-h*j3jgBރ4xÃ	Pqo
\tck8?L|i/}vx0;eC8J_4mL_JRqNVrQͭ+bdhl	'`\oAy}$JCm㽜6ïUO8vnE3:6JHNZ#iy|Rk-zZ
N,ًVqI6aQE2W؁}$WhPх*4%.G41xe`JE$W8W?#Y!.~M(v
xH.0+86eE*	M9Y*p>#ңAjgkH0Ѐx ;ĵR$Jn0hNa)h)mr̔cOE
X,J-0۽h(О>AΰY*NW{L.Vئa}U{<\u& [&~mE(6jk1#l8o+l;${Hrw
<R8˝Oݏ{x*BQgBN?&F|.b($ڸq[=3~sÄ
ũ9RoG7MApT3ATK=K|TZ7P^kLq3lpA',1KNZT-uVNNZ[C5mCVv~>R\a1[^[aJ6~?(Kv?wdkzӈjNA<.o}0_di4kq,R̔;+i*V(@ӣFE4=Ck
x^}LgS(/ZSd J((0dq%n*wm0nc0b̅1fNfc0bЭzO*}d\%縢a O>;"\};ww5x^VE3tbLXO&_Wrb_r\T17hƬX-scxp2ЮꧥXA+y1ZatF)P!כGφKGbim7
kl&1|nkVY']TؑXCRsvIR1\l}~BdB56HR-:ꬌmdB-T_+Q ]L,:;QjG&^jGLA3agDtddk	G\R0k\Dȵp?(@N6Z
4&5J˪XYbT"}!^ wmSA{':j(uiB,R䂴uvn\	XCiB:xɹ9*їХ4 -:S*R32t)$ŷCt:;kxك	iajRIM<%2*Ѿԏ/QVmÏ=Lq!ۻV{U2oD~,w?M	"wGp~$ՇkXQǐ 	fI_oJ jm(b!w=H$?o$vn
dvڐ {&cGvbᒂ1r!е].wc퍘n䮇I>bx]3_N aو^$TǸm o7`<lNzIQ4#0Y`@o3=]"A|$0(53
}-X`iVH:wE$هGo=!攤] RYסf_a|!Lm42S3wd33lddo͒(h.21t{&nL)laR$i,<4,@~'8Lg<T)\Z
0	+LGT"o[Zn}I4᐀PK9LJm۔wγ7Yt@TˏK&4qԽR$'2ͨʭd¥9~GGuxO%,b]~ըɄr?\(nmM--Lux^h[U֤KQԮnm-[&ל,bәky3/IԹ6-:&+s
Ψ--8d
P{{=z/|Ғ@}3`j[8 :py=+&/	_iV:aDtlfByL:T󾄅i\(BfSۉ$:НS?ź4!OVGԘcV=eiگLq
rB%:*!4[Ccv4Bͦx +D :7d!.QǓ:s4ဥ@'*p2J"#^3meeiB~m; 1i0}^kgiVm]t5SbLA2iԇAnPdWjyCY9\>=kYaH!Wgx A6=9s>V&L4?@v%qw#eq!YNpMDucjIǉw,!@tLpi$u̍kxkOJz/4e*q&esZKNSzk˩4-9C߀/pQٔG`\Bاpi^n\x86CzP:`HXeL5=z=]GL:40V
0j~뜳P%Ǻt+ӄv*u*sK>C͏:2ML]9"ZR2pY:N4ab#<9 έ=?I/'Cɠj	3>rR;J)3y<FiBPt`}q3&ZqVwJvΙ7%ReR)Q-XF0߈i|C:ww j0&xo1!Mфn]T(u?܄3h]o#Ob	
6_-ʆ~ן_*_	4CJvn=y+x"M_ieiL%{.LlHac54|yE~g%y6d$.j:]&72/vc89;:OJ'WTGR[ңЙKaaืmj#ŋN-x^he']J!Mul:];j17ݥr9/4-"DG	u+RuvctfGAéoޗ6{Ǘ@x><ϋ+: c?_7xg4z>2;1HL!%-v`hsA6"ӦTuhaЂET"nj*8
y1[
(ˇ.P!qDR0ӬmW^88Z) =hZ>?[8!p1%aF;SIB	҉	7!;"ɭ#[6ZΛh~q$6v\rDTܭi,;
կ%ʻ&!lMwuЖM0NϚ$Ќ+n]T*68RIe=!"d9R'8U+m|l78a4:r}iӲ;T%9Rqp6$(qô|L2^Csu;Y!-9~WD(CiJBIUWY	EG	29,<M",5;X>&qܒkE 	bz43"uquWaS"RRTn/84=&0NŐU*u MRFWę.Z%Dm\ސ末L
J~:R87TRS0dӡō =qB;n(zKJGzr`ߢ87Uvo7[TYf䐚U1]N9q`1M+7ml!yOata-xM2U>_$)9ed(BjF5uv8aqa:϶0lʀ6D05ϒ86>N|+tA(P8a^4DRn	/%1Zx~8foa`8`a~Ad*ߺEjrJc'p;Yi%˛Zx\=ȶEs`NX<^]z7ޫ	z$k.oaPDrVvnb`N螛ɛC
_[>ڄx^LUpD2 $fs[[`ΰ0-XwF76ɢ.HVcCd	&hpDpcef?1*0ab^%o ߻޽ϓ2?
^?2J+Lp8éwh}NHEjZιw$'WJ13^8"&[Kl(fP}Rmpho:C>NhFp\a!Ba?Ǒ;]=U;Y3q Ph}yf!qf5~\&=p0teR'ķ"<4[AňϷJz1@p!v;8 ăp%
U\}U8&h>nI!h3VwD!?̂X@ޠ$wvB4T	?Bɮz5԰%Aw)Z'\858ZGRL(^5iżT	 %!	]=y+oiZ܍-A*3 ldNEǅ*4@/нOo"q!^~	qvޟŉ:Sx嚓1AHnhyг;퍲(<|aэ8auw֍b/Mn_.mzT	}w2-"#m	hE-TN'uqBN_9yK g􀧱esԀtp
,e$ZRo'}h[9G{H!oD ^lx&:Ԓcf,6xv3fR'X$jwUI<J+xjW.ҭb	G3wӌ԰jW[oYImҏՊK	+DA ScHSNRyiA-H
۸d?g.*Ȫ#}sg-pT,a<rqKwkH]00N:Esfuqup\~N|EׯsvߐSCe!dX GP	R Oa'9	x^a:䗀Z
k@ldrX:O:NZy7:^!&tXW,}?}gTp!'MjUxC=}76ܙx/sֹ>l@0N>W7+\]ӿx^LeF	[-H[S(*,(vE4WZz'?ƢK6]d)sd$f&(1Ĺ4.A]L#1j{߻3oJ}#x;|~ųB~	ܾ:|3'<OU+_a[
1#ߔCG	cK$o0rS57P='&WzB2qKLx'D!߾vGǰ#֫d&5dXa3\3dWlv^Lrz.2.Nbd7
#B:ꎦ21*-L)\xV/,ðҽ<²I{B9EYTSˣyo:*+,ZQFN8%g~ɡK	CJSHd_.V20N8U?UCj@V,D:qA721JLzDq\m5</'H&Lk	Xp#9 jW;Rhf1nu	ENTSr622Nbr<z:ըsm	S܇ɹ:tFIuMF	Xʯ<-ŗR*UXMiȳ2,zC<YEzi	HNw>Q|`:l	ۗ877{@
!h$'l5&O&8^>/PANkRRNon  JC6(WoS(m#t~ǎ}!%hލܐJd`pb`<(aC͕d`P`vAtZM`/Mr]PE#*f/?bhշ?9!7){R/τ8V2)qH	gB%ҹ	]3+~>>Ii,Zo7
豀<%z;	ͧ:P߻yՖ6>[RzBt57#G|òGJիL}>N؏ (Z&5.Y&MNxK+s$MvG2(0s'd˗Bcge)5h#S`JS	E}lGQ=4WUo|rK9'U{j)3];pCZƮ*]xS_f x^PTUǿ ,
	jjf!u]$&J .^]EN2VC>!=,mqrò&GA(9{,NQ};|rVI^d2+=Q0А8rmY8a&u-zӻࡖ=@=ԣƀoȆrkdd L1&C p%VnҐpS@zhvgHr<)<q<5ȕ?'䈆!Qk^d`tmvA6:+ Ðw<GGHJmASf-uJ]ӟrDü1T:m=Z:%1^(z^Ư䈆@ܶLueI+/q*i~;]kZ#v>ڟ_Dl3'9s0b`u|i=z`x"$@{+3WʯUQo݇g9䈆TaV[IM|RAAik5b;C[:QVDH6ALXV}K|6oFJ[1Dl$ަ#zvc1PFP	*g/EF9:f@
gr3;+hhPhBg AlrR9ğ:&NbGT0	9HcB˂>qNVdr̡_:BN(LNGtdR(SAn爆*X@D	&re֧Jpx/bᄃV aǍLGVhRu*2P݊xtJj4**оlߋ!Ө|kY@ hBU0~;C4N iuiX rW$W)k+C!L>	viG큕8S}wto#3ݬX8`m\JZj8Iw`B4-ζzt=F/u(EPAs˧ZLGJ'lHy͎Խ2l4EB\Zƣ wOthИ-L]	[b:{
0l>?r69IY=ŲB$Pԗ]azm.L ORb9 )]MOsqr10n
	V).YsD8;hS=ޓZT5)3O<Ⱥ	LiQZ^~:V[q	s0^GŢ`S!*ɓŊYS0h7rHr]l=H{Ҫ61Mwӕ zʋtxr${u抅w䚉xKKqbVu#Dm'	}+(ў&"VQ_CHKw~*;c밍ϟ(A(Ժ7FdDvu*-$ǖ`hxVLR=x^lSU6B@P!n.Aan׏Wm-S0d!8ԈD	?bp,5CF0"c,`"Ѡ޾;*oƗw=jۂ08d^1<h-̄Q	mۢհs4/{f]9A[/Nr~¾0OP=Nr-HL2d_'T7zuG<FQ8TrS*.[$dUm2=N),aM5E+`p%˱]Z̫j*
ؒZ+uZaȵ^C
sJ28qOIQgYR6pE+IDڙ^]"SwlB!Q,+EJ#\ԩ,ӳ!?98+̔SvKznN,B6q.pϴSgp!RCIӻD5c3ߺsPJ17U1;1`KLByfnՑZ9 [4[/7jaWC&GJ2T?9B,j"_݄b9Vcu$ʑ*iԯ6=r>(G5ZzPi.ǎ;=^(Fp);A%	Igiݲ|"d#BL*j$偔,egs3 17 Nui#	jji")%A%ilZ&#@-EJ*Lee`crS\cU4:Q/3$sQ)CŚ-I\=mKe+c5UNZGIr`q:TùƁ[d}'[/bR[1mcSعGʷ0&q)5@Ue&>W_7)M+Ac}.<TCxɱ_C`Pe@wJWU7ܕ>Gw|R`5ց!^Ftqz{5*N;x]I;aņ` /{kP\@eZd^4Ivg}oyvC9)ܶ3qUMKNYg^YE]cfk:O嶿9D/?xn^?$ӏ%`}CtMx`Eb#^AboL9y!klUCP<֨NI&+X'ږsn~+>Bvބ׆#dv<!!UET֐3a.Za#LۓCS:As$CKi/7n!s{x\}CC&6d0g?]vW!5)9bγWli 1:x^LeǟzזB?StZ2tt0h,Q
i0?lQĨGb9 Ɵl5#qDǮrL޽>=w5&H|;=WvץMed]mB<څ'ͣO~rbjhEs
1xI":{ms\
y1BSS'uGuiɩQh.`$<nIS	}`~3Sgå#k%v.4ڶGNy3$)]QM-6BuCͣfl<<Q6ҿSVA*dP0K*ݡj/x)D[>xoh$Kܜks	Tspnw:8ϟת4Ƈmm<Yވ/ϜGX"Ha)phiXd)%|G%p('lf5SRtL[pEG&'E{يI&\TP~H2?6)A%Ç9+=b7P_ YP<g B",^fZ@_.8
^`HO,țDV=!Y3ɰDNUij{6X-ݟh|ӗO,W讌hNުO55Bw;NsroKRwHzcFQBB@HO߰M*Rg<(CfɈLv	OF2MnC2BwWD1pH*F0G(Gv]vBv_|	P#͝$VZcsR%_Xj_~NFlUH(qy	RE
R<[V.\oV6j)!oc]kj{&jAv~*>q:Kĭ
iuw$[Ň<QB3U	RH|f~y;H5WBY*>R-յPiLɛi3)>!k6eJ%ojFXFi.?<V
s^/Q9{o1gӃ;eZ~:׬]a1&)N*EΫEY@CWo6Λi4j'HXI^%K?KW(,4}(EK<5fHzo.yC;kU!_KB6Wk\/يx^f/prr+-h[ 
.ofp0N)ab 6dʟG AEɩ0u&2\bD+ F1''/)